,school number,graduate count,college bound,total college bound %,2- or 4-year college or university,2- or 4-year university %,total postsecondary bound,total postsecondary bound %,non-degree-granting postsecondary school,non-degree-granting postsecondary school %,specialized associate degree granting institution
0,3.0,149,79,53.02%,73,48.99%,83,55.70%,4,2.68%,6
1,9999.0,7,0,0.00%,0,0.00%,0,0.00%,0,0.00%,0
2,17.0,278,177,63.67%,177,63.67%,184,66.19%,7,2.52%,0
3,9999.0,2,0,0.00%,0,0.00%,0,0.00%,0,0.00%,0
4,6269.0,76,48,63.16%,44,57.89%,49,64.47%,1,1.32%,4
5,6271.0,202,146,72.28%,143,70.79%,153,75.74%,7,3.47%,3
6,9999.0,6,0,0.00%,0,0.00%,0,0.00%,0,0.00%,0
7,14.0,165,113,68.48%,100,60.61%,114,69.09%,1,0.61%,13
8,9999.0,6,0,0.00%,0,0.00%,0,0.00%,0,0.00%,0
9,21.0,105,70,66.67%,66,62.86%,74,70.48%,4,3.81%,4
10,9999.0,4,0,0.00%,0,0.00%,0,0.00%,0,0.00%,0
11,7727.0,123,94,76.42%,93,75.61%,98,79.67%,4,3.25%,1
12,7846.0,21,15,71.43%,5,23.81%,15,71.43%,0,0.00%,10
13,7562.0,34,31,91.18%,31,91.18%,31,91.18%,0,0.00%,0
14,8308.0,99,35,35.35%,35,35.35%,40,40.40%,5,5.05%,0
15,409.0,296,0,0.00%,0,0.00%,0,0.00%,0,0.00%,0
16,412.0,186,138,74.19%,126,67.74%,147,79.03%,9,4.84%,12
17,416.0,98,2,2.04%,2,2.04%,2,2.04%,0,0.00%,0
18,6047.0,7,0,0.00%,0,0.00%,0,0.00%,0,0.00%,0
19,6664.0,5,0,0.00%,0,0.00%,0,0.00%,0,0.00%,0
20,6811.0,9,0,0.00%,0,0.00%,0,0.00%,0,0.00%,0
21,6915.0,298,220,73.83%,214,71.81%,230,77.18%,10,3.36%,6
22,8105.0,103,4,3.88%,4,3.88%,4,3.88%,0,0.00%,0
23,8106.0,129,117,90.70%,117,90.70%,120,93.02%,3,2.33%,0
24,8107.0,88,2,2.27%,2,2.27%,2,2.27%,0,0.00%,0
25,8110.0,88,1,1.14%,1,1.14%,1,1.14%,0,0.00%,0
26,8203.0,87,0,0.00%,0,0.00%,0,0.00%,0,0.00%,0
27,8300.0,25,0,0.00%,0,0.00%,0,0.00%,0,0.00%,0
28,9999.0,27,0,0.00%,0,0.00%,0,0.00%,0,0.00%,0
29,7772.0,29,26,89.66%,25,86.21%,28,96.55%,2,6.90%,1
30,29.0,72,51,70.83%,49,68.06%,51,70.83%,0,0.00%,2
31,9999.0,2,0,0.00%,0,0.00%,0,0.00%,0,0.00%,0
32,5199.0,120,109,90.83%,106,88.33%,109,90.83%,0,0.00%,3
33,9999.0,2,1,50.00%,1,50.00%,1,50.00%,0,0.00%,0
34,315.0,355,318,89.58%,318,89.58%,319,89.86%,1,0.28%,0
35,9999.0,6,1,16.67%,1,16.67%,1,16.67%,0,0.00%,0
36,50.0,326,259,79.45%,249,76.38%,267,81.90%,8,2.45%,10
37,9999.0,6,0,0.00%,0,0.00%,0,0.00%,0,0.00%,0
38,62.0,371,310,83.56%,310,83.56%,310,83.56%,0,0.00%,0
39,9999.0,1,0,0.00%,0,0.00%,0,0.00%,0,0.00%,0
40,70.0,89,74,83.15%,72,80.90%,74,83.15%,0,0.00%,2
41,79.0,93,58,62.37%,58,62.37%,60,64.52%,2,2.15%,0
42,9999.0,1,0,0.00%,0,0.00%,0,0.00%,0,0.00%,0
43,6706.0,273,237,86.81%,228,83.52%,246,90.11%,9,3.30%,9
44,9999.0,3,0,0.00%,0,0.00%,0,0.00%,0,0.00%,0
45,8094.0,41,30,73.17%,28,68.29%,30,73.17%,0,0.00%,2
46,9999.0,2,0,0.00%,0,0.00%,0,0.00%,0,0.00%,0
47,8087.0,36,29,80.56%,28,77.78%,29,80.56%,0,0.00%,1
48,513.0,151,118,78.15%,118,78.15%,128,84.77%,10,6.62%,0
49,8340.0,104,78,75.00%,75,72.12%,78,75.00%,0,0.00%,3
50,9999.0,10,0,0.00%,0,0.00%,0,0.00%,0,0.00%,0
51,144.0,166,112,67.47%,105,63.25%,114,68.67%,2,1.20%,7
52,9999.0,2,0,0.00%,0,0.00%,1,50.00%,1,50.00%,0
53,7648.0,3,2,66.67%,2,66.67%,2,66.67%,0,0.00%,0
54,156.0,326,283,86.81%,280,85.89%,289,88.65%,6,1.84%,3
55,9999.0,4,1,25.00%,1,25.00%,1,25.00%,0,0.00%,0
56,170.0,276,202,73.19%,198,71.74%,203,73.55%,1,0.36%,4
57,9999.0,4,0,0.00%,0,0.00%,0,0.00%,0,0.00%,0
58,5190.0,252,218,86.51%,218,86.51%,227,90.08%,9,3.57%,0
59,9999.0,1,0,0.00%,0,0.00%,0,0.00%,0,0.00%,0
60,5153.0,166,110,66.27%,101,60.84%,114,68.67%,4,2.41%,9
61,9999.0,2,0,0.00%,0,0.00%,0,0.00%,0,0.00%,0
62,5112.0,134,107,79.85%,100,74.63%,107,79.85%,0,0.00%,7
63,9999.0,5,0,0.00%,0,0.00%,0,0.00%,0,0.00%,0
64,6105.0,246,162,65.85%,149,60.57%,195,79.27%,33,13.41%,13
65,5017.0,244,206,84.43%,204,83.61%,208,85.25%,2,0.82%,2
66,9999.0,3,0,0.00%,0,0.00%,0,0.00%,0,0.00%,0
67,4951.0,289,264,91.35%,259,89.62%,264,91.35%,0,0.00%,5
68,9999.0,4,1,25.00%,1,25.00%,1,25.00%,0,0.00%,0
69,254.0,428,406,94.86%,404,94.39%,406,94.86%,0,0.00%,2
70,9999.0,6,1,16.67%,1,16.67%,4,66.67%,3,50.00%,0
71,8305.0,657,502,76.41%,502,76.41%,502,76.41%,0,0.00%,0
72,9999.0,5,0,0.00%,0,0.00%,0,0.00%,0,0.00%,0
73,53.0,72,54,75.00%,54,75.00%,54,75.00%,0,0.00%,0
74,9999.0,1,0,0.00%,0,0.00%,0,0.00%,0,0.00%,0
75,7101.0,381,322,84.51%,319,83.73%,331,86.88%,9,2.36%,3
76,309.0,347,294,84.73%,280,80.69%,309,89.05%,15,4.32%,14
77,9999.0,2,0,0.00%,0,0.00%,0,0.00%,0,0.00%,0
78,435.0,320,240,75.00%,239,74.69%,259,80.94%,19,5.94%,1
79,9999.0,1,0,0.00%,0,0.00%,0,0.00%,0,0.00%,0
80,448.0,150,134,89.33%,133,88.67%,134,89.33%,0,0.00%,1
81,9999.0,9,1,11.11%,1,11.11%,2,22.22%,1,11.11%,0
82,6928.0,73,58,79.45%,56,76.71%,64,87.67%,6,8.22%,2
83,9999.0,1,0,0.00%,0,0.00%,0,0.00%,0,0.00%,0
84,460.0,349,262,75.07%,246,70.49%,264,75.64%,2,0.57%,16
85,9999.0,7,0,0.00%,0,0.00%,0,0.00%,0,0.00%,0
86,440.0,94,62,65.96%,59,62.77%,63,67.02%,1,1.06%,3
87,9999.0,4,0,0.00%,0,0.00%,0,0.00%,0,0.00%,0
88,470.0,180,158,87.78%,157,87.22%,171,95.00%,13,7.22%,1
89,9999.0,6,0,0.00%,0,0.00%,1,16.67%,1,16.67%,0
90,467.0,145,123,84.83%,120,82.76%,123,84.83%,0,0.00%,3
91,9999.0,2,0,0.00%,0,0.00%,0,0.00%,0,0.00%,0
92,196.0,113,76,67.26%,73,64.60%,78,69.03%,2,1.77%,3
93,9999.0,1,1,100.00%,1,100.00%,1,100.00%,0,0.00%,0
94,477.0,70,53,75.71%,53,75.71%,53,75.71%,0,0.00%,0
95,9999.0,12,3,25.00%,3,25.00%,3,25.00%,0,0.00%,0
96,492.0,357,338,94.68%,338,94.68%,340,95.24%,2,0.56%,0
97,9999.0,7,0,0.00%,0,0.00%,0,0.00%,0,0.00%,0
98,509.0,281,224,79.72%,214,76.16%,228,81.14%,4,1.42%,10
99,523.0,219,187,85.39%,183,83.56%,195,89.04%,8,3.65%,4
100,9999.0,2,0,0.00%,0,0.00%,0,0.00%,0,0.00%,0
101,536.0,242,184,76.03%,180,74.38%,188,77.69%,4,1.65%,4
102,9999.0,2,0,0.00%,0,0.00%,0,0.00%,0,0.00%,0
103,107.0,241,181,75.10%,175,72.61%,198,82.16%,17,7.05%,6
104,9999.0,9,0,0.00%,0,0.00%,0,0.00%,0,0.00%,0
105,7821.0,74,38,51.35%,36,48.65%,44,59.46%,6,8.11%,2
106,8129.0,56,36,64.29%,34,60.71%,37,66.07%,1,1.79%,2
107,2320.0,67,50,74.63%,48,71.64%,55,82.09%,5,7.46%,2
108,9999.0,2,0,0.00%,0,0.00%,0,0.00%,0,0.00%,0
109,7640.0,78,58,74.36%,56,71.79%,61,78.21%,3,3.85%,2
110,8342.0,211,0,0.00%,0,0.00%,0,0.00%,0,0.00%,0
111,9999.0,47,0,0.00%,0,0.00%,0,0.00%,0,0.00%,0
112,594.0,147,127,86.39%,124,84.35%,128,87.07%,1,0.68%,3
113,7923.0,60,39,65.00%,32,53.33%,42,70.00%,3,5.00%,7
114,4807.0,198,73,36.87%,64,32.32%,79,39.90%,6,3.03%,9
115,7859.0,119,97,81.51%,97,81.51%,99,83.19%,2,1.68%,0
116,8086.0,82,47,57.32%,47,57.32%,47,57.32%,0,0.00%,0
117,6555.0,175,114,65.14%,106,60.57%,120,68.57%,6,3.43%,8
118,640.0,182,137,75.27%,131,71.98%,138,75.82%,1,0.55%,6
119,649.0,115,57,49.57%,57,49.57%,62,53.91%,5,4.35%,0
120,9999.0,2,0,0.00%,0,0.00%,0,0.00%,0,0.00%,0
121,6707.0,180,117,65.00%,117,65.00%,124,68.89%,7,3.89%,0
122,9999.0,4,0,0.00%,0,0.00%,0,0.00%,0,0.00%,0
123,8044.0,138,118,85.51%,115,83.33%,118,85.51%,0,0.00%,3
124,6563.0,97,59,60.82%,57,58.76%,60,61.86%,1,1.03%,2
125,7650.0,"1,258",719,57.15%,609,48.41%,755,60.02%,36,2.86%,110
126,675.0,165,126,76.36%,113,68.48%,126,76.36%,0,0.00%,13
127,9999.0,1,1,100.00%,1,100.00%,1,100.00%,0,0.00%,0
128,695.0,90,64,71.11%,63,70.00%,66,73.33%,2,2.22%,1
129,9999.0,1,0,0.00%,0,0.00%,1,100.00%,1,100.00%,0
130,700.0,118,92,77.97%,92,77.97%,94,79.66%,2,1.69%,0
131,9999.0,2,0,0.00%,0,0.00%,0,0.00%,0,0.00%,0
132,8000.0,49,40,81.63%,40,81.63%,40,81.63%,0,0.00%,0
133,9999.0,2,0,0.00%,0,0.00%,0,0.00%,0,0.00%,0
134,714.0,98,78,79.59%,78,79.59%,80,81.63%,2,2.04%,0
135,9999.0,2,0,0.00%,0,0.00%,0,0.00%,0,0.00%,0
136,719.0,61,34,55.74%,30,49.18%,37,60.66%,3,4.92%,4
137,9999.0,1,0,0.00%,0,0.00%,0,0.00%,0,0.00%,0
138,726.0,155,76,49.03%,76,49.03%,80,51.61%,4,2.58%,0
139,732.0,111,67,60.36%,57,51.35%,67,60.36%,0,0.00%,10
140,9999.0,5,0,0.00%,0,0.00%,1,20.00%,1,20.00%,0
141,7897.0,131,73,55.73%,73,55.73%,79,60.31%,6,4.58%,0
142,9999.0,1,0,0.00%,0,0.00%,0,0.00%,0,0.00%,0
143,747.0,61,33,54.10%,30,49.18%,38,62.30%,5,8.20%,3
144,8154.0,21,13,61.90%,13,61.90%,14,66.67%,1,4.76%,0
145,753.0,80,38,47.50%,30,37.50%,41,51.25%,3,3.75%,8
146,8155.0,91,59,64.84%,54,59.34%,69,75.82%,10,10.99%,5
147,820.0,63,48,76.19%,44,69.84%,49,77.78%,1,1.59%,4
148,6306.0,541,387,71.53%,380,70.24%,397,73.38%,10,1.85%,7
149,9999.0,19,0,0.00%,0,0.00%,1,5.26%,1,5.26%,0
150,6308.0,124,91,73.39%,90,72.58%,91,73.39%,0,0.00%,1
151,777.0,202,158,78.22%,150,74.26%,163,80.69%,5,2.48%,8
152,9999.0,4,0,0.00%,0,0.00%,1,25.00%,1,25.00%,0
153,4810.0,270,202,74.81%,202,74.81%,214,79.26%,12,4.44%,0
154,9999.0,6,0,0.00%,0,0.00%,0,0.00%,0,0.00%,0
155,788.0,316,227,71.84%,222,70.25%,228,72.15%,1,0.32%,5
156,9999.0,1,1,100.00%,1,100.00%,1,100.00%,0,0.00%,0
157,5023.0,201,161,80.10%,156,77.61%,161,80.10%,0,0.00%,5
158,9999.0,5,0,0.00%,0,0.00%,0,0.00%,0,0.00%,0
159,802.0,283,180,63.60%,176,62.19%,183,64.66%,3,1.06%,4
160,808.0,166,106,63.86%,88,53.01%,107,64.46%,1,0.60%,18
161,9999.0,2,1,50.00%,0,0.00%,1,50.00%,0,0.00%,1
162,816.0,104,75,72.12%,75,72.12%,76,73.08%,1,0.96%,0
163,6610.0,306,230,75.16%,223,72.88%,231,75.49%,1,0.33%,7
164,9999.0,17,0,0.00%,0,0.00%,0,0.00%,0,0.00%,0
165,6318.0,129,83,64.34%,83,64.34%,87,67.44%,4,3.10%,0
166,9999.0,3,0,0.00%,0,0.00%,0,0.00%,0,0.00%,0
167,8116.0,760,390,51.32%,390,51.32%,408,53.68%,18,2.37%,0
168,9999.0,5,0,0.00%,0,0.00%,0,0.00%,0,0.00%,0
169,864.0,145,116,80.00%,113,77.93%,118,81.38%,2,1.38%,3
170,9999.0,1,0,0.00%,0,0.00%,0,0.00%,0,0.00%,0
171,4670.0,104,67,64.42%,67,64.42%,77,74.04%,10,9.62%,0
172,9999.0,1,0,0.00%,0,0.00%,0,0.00%,0,0.00%,0
173,873.0,251,195,77.69%,186,74.10%,197,78.49%,2,0.80%,9
174,9999.0,18,0,0.00%,0,0.00%,0,0.00%,0,0.00%,0
175,6980.0,452,302,66.81%,301,66.59%,310,68.58%,8,1.77%,1
176,887.0,163,138,84.66%,135,82.82%,140,85.89%,2,1.23%,3
177,9999.0,3,2,66.67%,2,66.67%,2,66.67%,0,0.00%,0
178,7720.0,19,13,68.42%,13,68.42%,13,68.42%,0,0.00%,0
179,913.0,550,325,59.09%,310,56.36%,337,61.27%,12,2.18%,15
180,7425.0,3,0,0.00%,0,0.00%,0,0.00%,0,0.00%,0
181,917.0,103,75,72.82%,75,72.82%,75,72.82%,0,0.00%,0
182,921.0,71,43,60.56%,34,47.89%,45,63.38%,2,2.82%,9
183,5207.0,280,187,66.79%,178,63.57%,194,69.29%,7,2.50%,9
184,9999.0,3,0,0.00%,0,0.00%,0,0.00%,0,0.00%,0
185,941.0,141,79,56.03%,78,55.32%,82,58.16%,3,2.13%,1
186,949.0,121,75,61.98%,68,56.20%,88,72.73%,13,10.74%,7
187,951.0,35,17,48.57%,14,40.00%,21,60.00%,4,11.43%,3
188,9999.0,1,0,0.00%,0,0.00%,0,0.00%,0,0.00%,0
189,958.0,157,77,49.04%,72,45.86%,85,54.14%,8,5.10%,5
190,988.0,53,30,56.60%,30,56.60%,31,58.49%,1,1.89%,0
191,964.0,76,43,56.58%,42,55.26%,47,61.84%,4,5.26%,1
192,965.0,58,43,74.14%,42,72.41%,45,77.59%,2,3.45%,1
193,5208.0,117,53,45.30%,46,39.32%,56,47.86%,3,2.56%,7
194,1000.0,74,31,41.89%,31,41.89%,34,45.95%,3,4.05%,0
195,1005.0,83,46,55.42%,45,54.22%,55,66.27%,9,10.84%,1
196,7726.0,19,6,31.58%,6,31.58%,8,42.11%,2,10.53%,0
197,5116.0,379,304,80.21%,301,79.42%,308,81.27%,4,1.06%,3
198,9999.0,8,0,0.00%,0,0.00%,0,0.00%,0,0.00%,0
199,1014.0,72,56,77.78%,56,77.78%,61,84.72%,5,6.94%,0
200,9999.0,5,0,0.00%,0,0.00%,0,0.00%,0,0.00%,0
201,1029.0,324,231,71.30%,231,71.30%,243,75.00%,12,3.70%,0
202,9999.0,56,0,0.00%,0,0.00%,0,0.00%,0,0.00%,0
203,1030.0,353,222,62.89%,204,57.79%,225,63.74%,3,0.85%,18
204,1040.0,431,360,83.53%,360,83.53%,368,85.38%,8,1.86%,0
205,9999.0,12,0,0.00%,0,0.00%,0,0.00%,0,0.00%,0
206,1043.0,449,402,89.53%,401,89.31%,404,89.98%,2,0.45%,1
207,5133.0,545,516,94.68%,516,94.68%,517,94.86%,1,0.18%,0
208,7790.0,606,556,91.75%,555,91.58%,563,92.90%,7,1.16%,1
209,9999.0,19,0,0.00%,0,0.00%,0,0.00%,0,0.00%,0
210,5096.0,437,404,92.45%,404,92.45%,406,92.91%,2,0.46%,0
211,7749.0,517,472,91.30%,472,91.30%,474,91.68%,2,0.39%,0
212,9999.0,1,0,0.00%,0,0.00%,0,0.00%,0,0.00%,0
213,8381.0,48,31,64.58%,29,60.42%,31,64.58%,0,0.00%,2
214,6455.0,571,538,94.22%,538,94.22%,553,96.85%,15,2.63%,0
215,9999.0,57,56,98.25%,56,98.25%,56,98.25%,0,0.00%,0
216,1084.0,146,141,96.58%,141,96.58%,142,97.26%,1,0.68%,0
217,9999.0,2,0,0.00%,0,0.00%,0,0.00%,0,0.00%,0
218,1094.0,133,98,73.68%,97,72.93%,100,75.19%,2,1.50%,1
219,9999.0,3,0,0.00%,0,0.00%,0,0.00%,0,0.00%,0
220,1100.0,584,483,82.71%,482,82.53%,492,84.25%,9,1.54%,1
221,9999.0,16,4,25.00%,4,25.00%,4,25.00%,0,0.00%,0
222,4682.0,778,637,81.88%,635,81.62%,649,83.42%,12,1.54%,2
223,9999.0,28,0,0.00%,0,0.00%,0,0.00%,0,0.00%,0
224,1128.0,405,300,74.07%,300,74.07%,310,76.54%,10,2.47%,0
225,9999.0,7,1,14.29%,1,14.29%,1,14.29%,0,0.00%,0
226,8344.0,480,397,82.71%,378,78.75%,409,85.21%,12,2.50%,19
227,9999.0,58,3,5.17%,3,5.17%,4,6.90%,1,1.72%,0
228,1154.0,127,80,62.99%,79,62.20%,83,65.35%,3,2.36%,1
229,9999.0,1,0,0.00%,0,0.00%,0,0.00%,0,0.00%,0
230,1159.0,258,232,89.92%,232,89.92%,244,94.57%,12,4.65%,0
231,9999.0,1,0,0.00%,0,0.00%,0,0.00%,0,0.00%,0
232,1164.0,123,69,56.10%,65,52.85%,69,56.10%,0,0.00%,4
233,1172.0,181,146,80.66%,146,80.66%,147,81.22%,1,0.55%,0
234,1177.0,223,171,76.68%,171,76.68%,172,77.13%,1,0.45%,0
235,9999.0,1,0,0.00%,0,0.00%,0,0.00%,0,0.00%,0
236,8318.0,575,514,89.39%,498,86.61%,519,90.26%,5,0.87%,16
237,9999.0,3,0,0.00%,0,0.00%,0,0.00%,0,0.00%,0
238,5135.0,42,25,59.52%,24,57.14%,25,59.52%,0,0.00%,1
239,9999.0,5,0,0.00%,0,0.00%,0,0.00%,0,0.00%,0
240,5212.0,111,79,71.17%,76,68.47%,79,71.17%,0,0.00%,3
241,9999.0,1,0,0.00%,0,0.00%,0,0.00%,0,0.00%,0
242,1208.0,131,98,74.81%,93,70.99%,99,75.57%,1,0.76%,5
243,5136.0,58,49,84.48%,49,84.48%,49,84.48%,0,0.00%,0
244,1225.0,42,15,35.71%,14,33.33%,15,35.71%,0,0.00%,1
245,9999.0,3,0,0.00%,0,0.00%,0,0.00%,0,0.00%,0
246,8382.0,159,104,65.41%,94,59.12%,112,70.44%,8,5.03%,10
247,1251.0,187,113,60.43%,104,55.61%,114,60.96%,1,0.53%,9
248,8314.0,7,1,14.29%,1,14.29%,1,14.29%,0,0.00%,0
249,9999.0,8,0,0.00%,0,0.00%,0,0.00%,0,0.00%,0
250,6201.0,89,51,57.30%,51,57.30%,51,57.30%,0,0.00%,0
251,1213.0,127,90,70.87%,89,70.08%,91,71.65%,1,0.79%,1
252,1270.0,51,37,72.55%,33,64.71%,41,80.39%,4,7.84%,4
253,7941.0,124,95,76.61%,94,75.81%,97,78.23%,2,1.61%,1
254,9999.0,2,1,50.00%,1,50.00%,1,50.00%,0,0.00%,0
255,8379.0,111,96,86.49%,95,85.59%,96,86.49%,0,0.00%,1
256,1299.0,46,29,63.04%,26,56.52%,29,63.04%,0,0.00%,3
257,4870.0,84,54,64.29%,54,64.29%,54,64.29%,0,0.00%,0
258,1307.0,135,111,82.22%,108,80.00%,114,84.44%,3,2.22%,3
259,9999.0,3,0,0.00%,0,0.00%,0,0.00%,0,0.00%,0
260,1315.0,151,109,72.19%,106,70.20%,115,76.16%,6,3.97%,3
261,4734.0,85,67,78.82%,64,75.29%,68,80.00%,1,1.18%,3
262,9999.0,8,2,25.00%,2,25.00%,2,25.00%,0,0.00%,0
263,8348.0,78,51,65.38%,50,64.10%,51,65.38%,0,0.00%,1
264,1327.0,63,45,71.43%,45,71.43%,46,73.02%,1,1.59%,0
265,9999.0,3,0,0.00%,0,0.00%,0,0.00%,0,0.00%,0
266,1335.0,140,82,58.57%,76,54.29%,88,62.86%,6,4.29%,6
267,1343.0,189,123,65.08%,120,63.49%,127,67.20%,4,2.12%,3
268,9999.0,1,0,0.00%,0,0.00%,0,0.00%,0,0.00%,0
269,6231.0,117,81,69.23%,77,65.81%,84,71.79%,3,2.56%,4
270,1364.0,531,409,77.02%,403,75.89%,409,77.02%,0,0.00%,6
271,7691.0,153,74,48.37%,70,45.75%,81,52.94%,7,4.58%,4
272,7721.0,74,62,83.78%,57,77.03%,62,83.78%,0,0.00%,5
273,7819.0,296,191,64.53%,190,64.19%,213,71.96%,22,7.43%,1
274,1367.0,450,389,86.44%,386,85.78%,399,88.67%,10,2.22%,3
275,9999.0,9,2,22.22%,2,22.22%,3,33.33%,1,11.11%,0
276,5012.0,429,288,67.13%,267,62.24%,302,70.40%,14,3.26%,21
277,9999.0,9,1,11.11%,1,11.11%,1,11.11%,0,0.00%,0
278,1387.0,347,303,87.32%,300,86.46%,304,87.61%,1,0.29%,3
279,7759.0,428,387,90.42%,387,90.42%,390,91.12%,3,0.70%,0
280,8174.0,179,177,98.88%,177,98.88%,177,98.88%,0,0.00%,0
281,9999.0,10,0,0.00%,0,0.00%,0,0.00%,0,0.00%,0
282,7628.0,68,57,83.82%,57,83.82%,58,85.29%,1,1.47%,0
283,7636.0,72,62,86.11%,62,86.11%,62,86.11%,0,0.00%,0
284,1424.0,320,300,93.75%,300,93.75%,302,94.38%,2,0.63%,0
285,9999.0,13,9,69.23%,9,69.23%,9,69.23%,0,0.00%,0
286,6482.0,283,232,81.98%,229,80.92%,240,84.81%,8,2.83%,3
287,9999.0,7,0,0.00%,0,0.00%,0,0.00%,0,0.00%,0
288,1414.0,183,130,71.04%,118,64.48%,131,71.58%,1,0.55%,12
289,9999.0,8,0,0.00%,0,0.00%,0,0.00%,0,0.00%,0
290,1406.0,361,325,90.03%,325,90.03%,330,91.41%,5,1.39%,0
291,9999.0,35,19,54.29%,18,51.43%,21,60.00%,2,5.71%,1
292,1420.0,306,230,75.16%,226,73.86%,240,78.43%,10,3.27%,4
293,1426.0,263,218,82.89%,218,82.89%,221,84.03%,3,1.14%,0
294,9999.0,12,3,25.00%,2,16.67%,3,25.00%,0,0.00%,1
295,1423.0,488,480,98.36%,480,98.36%,481,98.57%,1,0.20%,0
296,9999.0,31,9,29.03%,9,29.03%,9,29.03%,0,0.00%,0
297,1443.0,285,266,93.33%,266,93.33%,272,95.44%,6,2.11%,0
298,9999.0,8,0,0.00%,0,0.00%,0,0.00%,0,0.00%,0
299,1453.0,312,279,89.42%,279,89.42%,286,91.67%,7,2.24%,0
300,6734.0,334,315,94.31%,315,94.31%,323,96.71%,8,2.40%,0
301,7894.0,315,286,90.79%,286,90.79%,295,93.65%,9,2.86%,0
302,9999.0,36,1,2.78%,1,2.78%,1,2.78%,0,0.00%,0
303,7824.0,107,49,45.79%,45,42.06%,57,53.27%,8,7.48%,4
304,4664.0,46,29,63.04%,25,54.35%,30,65.22%,1,2.17%,4
305,9999.0,8,0,0.00%,0,0.00%,0,0.00%,0,0.00%,0
306,1475.0,70,49,70.00%,43,61.43%,49,70.00%,0,0.00%,6
307,9999.0,2,1,50.00%,0,0.00%,1,50.00%,0,0.00%,1
308,1480.0,71,46,64.79%,40,56.34%,46,64.79%,0,0.00%,6
309,9999.0,1,0,0.00%,0,0.00%,0,0.00%,0,0.00%,0
310,1486.0,80,44,55.00%,42,52.50%,51,63.75%,7,8.75%,2
311,1489.0,37,28,75.68%,28,75.68%,28,75.68%,0,0.00%,0
312,1495.0,97,43,44.33%,42,43.30%,52,53.61%,9,9.28%,1
313,1501.0,36,21,58.33%,18,50.00%,22,61.11%,1,2.78%,3
314,6156.0,231,147,63.64%,135,58.44%,155,67.10%,8,3.46%,12
315,9999.0,3,0,0.00%,0,0.00%,0,0.00%,0,0.00%,0
316,6236.0,187,110,58.82%,105,56.15%,111,59.36%,1,0.53%,5
317,1529.0,84,60,71.43%,42,50.00%,62,73.81%,2,2.38%,18
318,9999.0,1,0,0.00%,0,0.00%,0,0.00%,0,0.00%,0
319,5219.0,60,42,70.00%,40,66.67%,45,75.00%,3,5.00%,2
320,9999.0,3,0,0.00%,0,0.00%,0,0.00%,0,0.00%,0
321,8316.0,17,7,41.18%,7,41.18%,7,41.18%,0,0.00%,0
322,1550.0,71,36,50.70%,35,49.30%,43,60.56%,7,9.86%,1
323,1560.0,96,56,58.33%,53,55.21%,57,59.38%,1,1.04%,3
324,9999.0,2,0,0.00%,0,0.00%,0,0.00%,0,0.00%,0
325,1566.0,76,42,55.26%,40,52.63%,48,63.16%,6,7.89%,2
326,7635.0,23,5,21.74%,5,21.74%,7,30.43%,2,8.70%,0
327,6241.0,29,13,44.83%,11,37.93%,14,48.28%,1,3.45%,2
328,7589.0,289,176,60.90%,163,56.40%,177,61.25%,1,0.35%,13
329,1595.0,37,23,62.16%,23,62.16%,24,64.86%,1,2.70%,0
330,1605.0,165,126,76.36%,125,75.76%,126,76.36%,0,0.00%,1
331,1612.0,96,77,80.21%,77,80.21%,78,81.25%,1,1.04%,0
332,9999.0,3,0,0.00%,0,0.00%,0,0.00%,0,0.00%,0
333,1619.0,117,93,79.49%,92,78.63%,95,81.20%,2,1.71%,1
334,9999.0,8,0,0.00%,0,0.00%,0,0.00%,0,0.00%,0
335,5178.0,128,34,26.56%,30,23.44%,41,32.03%,7,5.47%,4
336,1623.0,49,31,63.27%,31,63.27%,32,65.31%,1,2.04%,0
337,1627.0,92,68,73.91%,68,73.91%,69,75.00%,1,1.09%,0
338,7567.0,28,11,39.29%,11,39.29%,12,42.86%,1,3.57%,0
339,8224.0,165,84,50.91%,75,45.45%,85,51.52%,1,0.61%,9
340,1632.0,70,0,0.00%,0,0.00%,0,0.00%,0,0.00%,0
341,1654.0,173,111,64.16%,103,59.54%,116,67.05%,5,2.89%,8
342,9999.0,3,0,0.00%,0,0.00%,0,0.00%,0,0.00%,0
343,1629.0,82,53,64.63%,48,58.54%,53,64.63%,0,0.00%,5
344,6136.0,93,53,56.99%,48,51.61%,54,58.06%,1,1.08%,5
345,6942.0,75,50,66.67%,39,52.00%,50,66.67%,0,0.00%,11
346,9999.0,2,0,0.00%,0,0.00%,0,0.00%,0,0.00%,0
347,1677.0,212,128,60.38%,123,58.02%,129,60.85%,1,0.47%,5
348,1682.0,94,83,88.30%,83,88.30%,83,88.30%,0,0.00%,0
349,1694.0,338,259,76.63%,258,76.33%,263,77.81%,4,1.18%,1
350,9999.0,1,0,0.00%,0,0.00%,0,0.00%,0,0.00%,0
351,1701.0,647,545,84.23%,545,84.23%,546,84.39%,1,0.15%,0
352,9999.0,4,0,0.00%,0,0.00%,0,0.00%,0,0.00%,0
353,1707.0,185,132,71.35%,132,71.35%,132,71.35%,0,0.00%,0
354,9999.0,2,0,0.00%,0,0.00%,0,0.00%,0,0.00%,0
355,5098.0,274,225,82.12%,219,79.93%,225,82.12%,0,0.00%,6
356,9999.0,3,1,33.33%,1,33.33%,1,33.33%,0,0.00%,0
357,5221.0,249,154,61.85%,143,57.43%,156,62.65%,2,0.80%,11
358,6328.0,153,105,68.63%,101,66.01%,107,69.93%,2,1.31%,4
359,7774.0,834,476,57.07%,475,56.95%,556,66.67%,80,9.59%,1
360,1745.0,393,324,82.44%,322,81.93%,332,84.48%,8,2.04%,2
361,1746.0,312,115,36.86%,115,36.86%,115,36.86%,0,0.00%,0
362,9999.0,4,0,0.00%,0,0.00%,0,0.00%,0,0.00%,0
363,5278.0,237,109,45.99%,97,40.93%,121,51.05%,12,5.06%,12
364,4801.0,277,247,89.17%,247,89.17%,249,89.89%,2,0.72%,0
365,9999.0,4,0,0.00%,0,0.00%,0,0.00%,0,0.00%,0
366,6330.0,50,31,62.00%,29,58.00%,31,62.00%,0,0.00%,2
367,6333.0,179,103,57.54%,103,57.54%,103,57.54%,0,0.00%,0
368,7902.0,81,79,97.53%,78,96.30%,79,97.53%,0,0.00%,1
369,8376.0,15,4,26.67%,4,26.67%,4,26.67%,0,0.00%,0
370,9999.0,23,0,0.00%,0,0.00%,0,0.00%,0,0.00%,0
371,1776.0,265,169,63.77%,169,63.77%,170,64.15%,1,0.38%,0
372,7844.0,5,0,0.00%,0,0.00%,0,0.00%,0,0.00%,0
373,9999.0,2,0,0.00%,0,0.00%,0,0.00%,0,0.00%,0
374,1790.0,150,98,65.33%,97,64.67%,102,68.00%,4,2.67%,1
375,9999.0,1,0,0.00%,0,0.00%,0,0.00%,0,0.00%,0
376,1794.0,50,28,56.00%,28,56.00%,28,56.00%,0,0.00%,0
377,8278.0,48,35,72.92%,35,72.92%,35,72.92%,0,0.00%,0
378,1801.0,61,20,32.79%,18,29.51%,21,34.43%,1,1.64%,2
379,9999.0,4,0,0.00%,0,0.00%,0,0.00%,0,0.00%,0
380,1806.0,211,180,85.31%,178,84.36%,180,85.31%,0,0.00%,2
381,9999.0,2,0,0.00%,0,0.00%,0,0.00%,0,0.00%,0
382,6340.0,81,53,65.43%,48,59.26%,56,69.14%,3,3.70%,5
383,9999.0,4,0,0.00%,0,0.00%,0,0.00%,0,0.00%,0
384,6492.0,184,97,52.72%,97,52.72%,97,52.72%,0,0.00%,0
385,8303.0,102,78,76.47%,78,76.47%,79,77.45%,1,0.98%,0
386,9999.0,21,0,0.00%,0,0.00%,0,0.00%,0,0.00%,0
387,1849.0,219,170,77.63%,166,75.80%,184,84.02%,14,6.39%,4
388,9999.0,8,0,0.00%,0,0.00%,0,0.00%,0,0.00%,0
389,1869.0,398,364,91.46%,364,91.46%,366,91.96%,2,0.50%,0
390,9999.0,2,0,0.00%,0,0.00%,1,50.00%,1,50.00%,0
391,1879.0,427,397,92.97%,390,91.33%,401,93.91%,4,0.94%,7
392,9999.0,9,2,22.22%,2,22.22%,2,22.22%,0,0.00%,0
393,1885.0,271,194,71.59%,192,70.85%,199,73.43%,5,1.85%,2
394,9999.0,6,0,0.00%,0,0.00%,0,0.00%,0,0.00%,0
395,1902.0,293,265,90.44%,252,86.01%,267,91.13%,2,0.68%,13
396,9999.0,7,2,28.57%,2,28.57%,2,28.57%,0,0.00%,0
397,1915.0,236,200,84.75%,191,80.93%,201,85.17%,1,0.42%,9
398,9999.0,4,0,0.00%,0,0.00%,0,0.00%,0,0.00%,0
399,1921.0,323,304,94.12%,303,93.81%,304,94.12%,0,0.00%,1
400,1934.0,438,371,84.70%,368,84.02%,377,86.07%,6,1.37%,3
401,9999.0,5,0,0.00%,0,0.00%,0,0.00%,0,0.00%,0
402,1942.0,299,278,92.98%,278,92.98%,281,93.98%,3,1.00%,0
403,9999.0,3,2,66.67%,2,66.67%,2,66.67%,0,0.00%,0
404,6516.0,302,182,60.26%,182,60.26%,198,65.56%,16,5.30%,0
405,1950.0,323,286,88.54%,284,87.93%,298,92.26%,12,3.72%,2
406,9999.0,7,1,14.29%,1,14.29%,1,14.29%,0,0.00%,0
407,1972.0,771,418,54.22%,418,54.22%,434,56.29%,16,2.08%,0
408,9999.0,22,5,22.73%,5,22.73%,5,22.73%,0,0.00%,0
409,5287.0,294,274,93.20%,272,92.52%,275,93.54%,1,0.34%,2
410,9999.0,2,0,0.00%,0,0.00%,0,0.00%,0,0.00%,0
411,8231.0,306,174,56.86%,169,55.23%,174,56.86%,0,0.00%,5
412,9999.0,3,0,0.00%,0,0.00%,0,0.00%,0,0.00%,0
413,6218.0,35,22,62.86%,22,62.86%,24,68.57%,2,5.71%,0
414,1989.0,65,41,63.08%,40,61.54%,42,64.62%,1,1.54%,1
415,5169.0,147,81,55.10%,80,54.42%,93,63.27%,12,8.16%,1
416,7770.0,78,41,52.56%,38,48.72%,46,58.97%,5,6.41%,3
417,1998.0,147,71,48.30%,63,42.86%,77,52.38%,6,4.08%,8
418,2026.0,156,56,35.90%,51,32.69%,58,37.18%,2,1.28%,5
419,2027.0,114,61,53.51%,61,53.51%,61,53.51%,0,0.00%,0
420,7294.0,178,84,47.19%,71,39.89%,86,48.31%,2,1.12%,13
421,7515.0,186,185,99.46%,184,98.92%,186,100.00%,1,0.54%,1
422,9999.0,2,0,0.00%,0,0.00%,0,0.00%,0,0.00%,0
423,6737.0,118,99,83.90%,99,83.90%,103,87.29%,4,3.39%,0
424,2037.0,171,106,61.99%,102,59.65%,114,66.67%,8,4.68%,4
425,9999.0,1,0,0.00%,0,0.00%,0,0.00%,0,0.00%,0
426,2040.0,179,127,70.95%,127,70.95%,131,73.18%,4,2.23%,0
427,9999.0,1,0,0.00%,0,0.00%,0,0.00%,0,0.00%,0
428,2043.0,148,95,64.19%,86,58.11%,98,66.22%,3,2.03%,9
429,9999.0,2,0,0.00%,0,0.00%,0,0.00%,0,0.00%,0
430,7948.0,146,103,70.55%,101,69.18%,104,71.23%,1,0.68%,2
431,4817.0,86,48,55.81%,46,53.49%,55,63.95%,7,8.14%,2
432,9999.0,1,0,0.00%,0,0.00%,0,0.00%,0,0.00%,0
433,8071.0,549,373,67.94%,364,66.30%,378,68.85%,5,0.91%,9
434,9999.0,1,0,0.00%,0,0.00%,0,0.00%,0,0.00%,0
435,6145.0,119,76,63.87%,74,62.18%,79,66.39%,3,2.52%,2
436,6745.0,108,66,61.11%,58,53.70%,76,70.37%,10,9.26%,8
437,9999.0,1,0,0.00%,0,0.00%,0,0.00%,0,0.00%,0
438,2075.0,67,39,58.21%,39,58.21%,39,58.21%,0,0.00%,0
439,6148.0,100,57,57.00%,56,56.00%,57,57.00%,0,0.00%,1
440,6001.0,264,136,51.52%,110,41.67%,139,52.65%,3,1.14%,26
441,4818.0,104,66,63.46%,59,56.73%,68,65.38%,2,1.92%,7
442,5228.0,220,141,64.09%,138,62.73%,153,69.55%,12,5.45%,3
443,2126.0,80,53,66.25%,53,66.25%,56,70.00%,3,3.75%,0
444,6600.0,210,152,72.38%,144,68.57%,159,75.71%,7,3.33%,8
445,9999.0,5,0,0.00%,0,0.00%,0,0.00%,0,0.00%,0
446,6643.0,110,25,22.73%,25,22.73%,45,40.91%,20,18.18%,0
447,2184.0,168,98,58.33%,89,52.98%,98,58.33%,0,0.00%,9
448,9999.0,4,0,0.00%,0,0.00%,0,0.00%,0,0.00%,0
449,6159.0,21,10,47.62%,9,42.86%,10,47.62%,0,0.00%,1
450,6161.0,18,9,50.00%,8,44.44%,9,50.00%,0,0.00%,1
451,9999.0,12,0,0.00%,0,0.00%,0,0.00%,0,0.00%,0
452,2191.0,476,230,48.32%,230,48.32%,245,51.47%,15,3.15%,0
453,8244.0,167,64,38.32%,55,32.93%,76,45.51%,12,7.19%,9
454,9999.0,9,0,0.00%,0,0.00%,0,0.00%,0,0.00%,0
455,2201.0,34,14,41.18%,13,38.24%,14,41.18%,0,0.00%,1
456,2206.0,216,138,63.89%,134,62.04%,145,67.13%,7,3.24%,4
457,9999.0,1,0,0.00%,0,0.00%,0,0.00%,0,0.00%,0
458,6280.0,197,111,56.35%,109,55.33%,120,60.91%,9,4.57%,2
459,9999.0,2,0,0.00%,0,0.00%,0,0.00%,0,0.00%,0
460,2243.0,324,182,56.17%,172,53.09%,185,57.10%,3,0.93%,10
461,9999.0,11,0,0.00%,0,0.00%,0,0.00%,0,0.00%,0
462,6252.0,68,43,63.24%,43,63.24%,44,64.71%,1,1.47%,0
463,9999.0,1,0,0.00%,0,0.00%,0,0.00%,0,0.00%,0
464,2246.0,24,0,0.00%,0,0.00%,0,0.00%,0,0.00%,0
465,2253.0,69,38,55.07%,38,55.07%,39,56.52%,1,1.45%,0
466,7112.0,79,46,58.23%,40,50.63%,48,60.76%,2,2.53%,6
467,5118.0,123,77,62.60%,69,56.10%,78,63.41%,1,0.81%,8
468,2280.0,57,40,70.18%,38,66.67%,41,71.93%,1,1.75%,2
469,2284.0,51,34,66.67%,32,62.75%,36,70.59%,2,3.92%,2
470,9999.0,2,0,0.00%,0,0.00%,0,0.00%,0,0.00%,0
471,7136.0,43,28,65.12%,27,62.79%,28,65.12%,0,0.00%,1
472,9999.0,2,0,0.00%,0,0.00%,0,0.00%,0,0.00%,0
473,2305.0,155,101,65.16%,89,57.42%,102,65.81%,1,0.65%,12
474,2308.0,46,25,54.35%,25,54.35%,29,63.04%,4,8.70%,0
475,7944.0,98,55,56.12%,53,54.08%,59,60.20%,4,4.08%,2
476,2313.0,104,53,50.96%,52,50.00%,57,54.81%,4,3.85%,1
477,7762.0,25,0,0.00%,0,0.00%,1,4.00%,1,4.00%,0
478,2353.0,41,29,70.73%,29,70.73%,30,73.17%,1,2.44%,0
479,4706.0,63,45,71.43%,42,66.67%,45,71.43%,0,0.00%,3
480,9999.0,1,0,0.00%,0,0.00%,0,0.00%,0,0.00%,0
481,2331.0,54,43,79.63%,43,79.63%,43,79.63%,0,0.00%,0
482,2325.0,187,133,71.12%,133,71.12%,133,71.12%,0,0.00%,0
483,9999.0,1,0,0.00%,0,0.00%,0,0.00%,0,0.00%,0
484,2339.0,100,0,0.00%,0,0.00%,0,0.00%,0,0.00%,0
485,2345.0,53,33,62.26%,27,50.94%,35,66.04%,2,3.77%,6
486,2350.0,69,26,37.68%,24,34.78%,40,57.97%,14,20.29%,2
487,2358.0,88,52,59.09%,50,56.82%,54,61.36%,2,2.27%,2
488,9999.0,1,0,0.00%,0,0.00%,0,0.00%,0,0.00%,0
489,2362.0,71,44,61.97%,43,60.56%,46,64.79%,2,2.82%,1
490,6162.0,107,74,69.16%,74,69.16%,78,72.90%,4,3.74%,0
491,5180.0,84,18,21.43%,16,19.05%,20,23.81%,2,2.38%,2
492,6165.0,150,90,60.00%,90,60.00%,105,70.00%,15,10.00%,0
493,2394.0,88,53,60.23%,42,47.73%,55,62.50%,2,2.27%,11
494,6255.0,133,71,53.38%,41,30.83%,71,53.38%,0,0.00%,30
495,5091.0,253,228,90.12%,225,88.93%,230,90.91%,2,0.79%,3
496,2420.0,117,84,71.79%,84,71.79%,86,73.50%,2,1.71%,0
497,9999.0,2,0,0.00%,0,0.00%,0,0.00%,0,0.00%,0
498,8312.0,113,94,83.19%,94,83.19%,100,88.50%,6,5.31%,0
499,6404.0,119,119,100.00%,0,0.00%,119,100.00%,0,0.00%,119
500,8304.0,105,74,70.48%,74,70.48%,74,70.48%,0,0.00%,0
501,2446.0,214,162,75.70%,161,75.23%,164,76.64%,2,0.93%,1
502,2449.0,76,62,81.58%,62,81.58%,68,89.47%,6,7.89%,0
503,9999.0,1,0,0.00%,0,0.00%,0,0.00%,0,0.00%,0
504,2496.0,89,70,78.65%,63,70.79%,71,79.78%,1,1.12%,7
505,2489.0,189,121,64.02%,121,64.02%,125,66.14%,4,2.12%,0
506,6413.0,361,240,66.48%,240,66.48%,257,71.19%,17,4.71%,0
507,9999.0,42,10,23.81%,10,23.81%,11,26.19%,1,2.38%,0
508,6775.0,178,147,82.58%,144,80.90%,156,87.64%,9,5.06%,3
509,6290.0,234,148,63.25%,138,58.97%,149,63.68%,1,0.43%,10
510,9999.0,4,0,0.00%,0,0.00%,0,0.00%,0,0.00%,0
511,2515.0,67,44,65.67%,35,52.24%,44,65.67%,0,0.00%,9
512,2532.0,332,231,69.58%,230,69.28%,234,70.48%,3,0.90%,1
513,9999.0,26,9,34.62%,8,30.77%,9,34.62%,0,0.00%,1
514,2539.0,213,137,64.32%,128,60.09%,140,65.73%,3,1.41%,9
515,9999.0,8,2,25.00%,2,25.00%,2,25.00%,0,0.00%,0
516,2554.0,249,122,49.00%,119,47.79%,130,52.21%,8,3.21%,3
517,2562.0,285,191,67.02%,191,67.02%,201,70.53%,10,3.51%,0
518,6293.0,310,197,63.55%,181,58.39%,201,64.84%,4,1.29%,16
519,9999.0,2,0,0.00%,0,0.00%,0,0.00%,0,0.00%,0
520,7538.0,25,18,72.00%,18,72.00%,18,72.00%,0,0.00%,0
521,2578.0,527,394,74.76%,386,73.24%,398,75.52%,4,0.76%,8
522,9999.0,11,0,0.00%,0,0.00%,2,18.18%,2,18.18%,0
523,2607.0,225,171,76.00%,157,69.78%,175,77.78%,4,1.78%,14
524,9999.0,3,0,0.00%,0,0.00%,0,0.00%,0,0.00%,0
525,2596.0,592,437,73.82%,360,60.81%,464,78.38%,27,4.56%,77
526,7922.0,107,56,52.34%,56,52.34%,56,52.34%,0,0.00%,0
527,9999.0,22,3,13.64%,1,4.55%,3,13.64%,0,0.00%,2
528,2618.0,178,112,62.92%,102,57.30%,113,63.48%,1,0.56%,10
529,9999.0,54,18,33.33%,13,24.07%,19,35.19%,1,1.85%,5
530,2623.0,403,340,84.37%,323,80.15%,354,87.84%,14,3.47%,17
531,9999.0,7,2,28.57%,2,28.57%,2,28.57%,0,0.00%,0
532,2633.0,447,293,65.55%,276,61.74%,295,66.00%,2,0.45%,17
533,9999.0,9,0,0.00%,0,0.00%,0,0.00%,0,0.00%,0
534,2649.0,119,69,57.98%,61,51.26%,72,60.50%,3,2.52%,8
535,9999.0,4,0,0.00%,0,0.00%,0,0.00%,0,0.00%,0
536,2658.0,270,142,52.59%,131,48.52%,149,55.19%,7,2.59%,11
537,9999.0,7,0,0.00%,0,0.00%,0,0.00%,0,0.00%,0
538,2663.0,338,236,69.82%,233,68.93%,238,70.41%,2,0.59%,3
539,2675.0,109,84,77.06%,78,71.56%,84,77.06%,0,0.00%,6
540,9999.0,1,0,0.00%,0,0.00%,0,0.00%,0,0.00%,0
541,2680.0,111,85,76.58%,83,74.77%,102,91.89%,17,15.32%,2
542,4940.0,116,36,31.03%,36,31.03%,53,45.69%,17,14.66%,0
543,2686.0,95,69,72.63%,64,67.37%,71,74.74%,2,2.11%,5
544,2689.0,91,78,85.71%,76,83.52%,82,90.11%,4,4.40%,2
545,9999.0,2,0,0.00%,0,0.00%,1,50.00%,1,50.00%,0
546,2704.0,146,104,71.23%,100,68.49%,105,71.92%,1,0.68%,4
547,9999.0,15,0,0.00%,0,0.00%,0,0.00%,0,0.00%,0
548,2708.0,68,50,73.53%,49,72.06%,52,76.47%,2,2.94%,1
549,2712.0,59,51,86.44%,48,81.36%,51,86.44%,0,0.00%,3
550,9999.0,1,0,0.00%,0,0.00%,0,0.00%,0,0.00%,0
551,2721.0,84,68,80.95%,64,76.19%,68,80.95%,0,0.00%,4
552,9999.0,1,0,0.00%,0,0.00%,0,0.00%,0,0.00%,0
553,2725.0,116,74,63.79%,73,62.93%,77,66.38%,3,2.59%,1
554,9999.0,1,0,0.00%,0,0.00%,0,0.00%,0,0.00%,0
555,4800.0,342,207,60.53%,193,56.43%,213,62.28%,6,1.75%,14
556,2740.0,158,87,55.06%,87,55.06%,87,55.06%,0,0.00%,0
557,9999.0,4,0,0.00%,0,0.00%,0,0.00%,0,0.00%,0
558,5155.0,238,148,62.18%,122,51.26%,153,64.29%,5,2.10%,26
559,9999.0,15,0,0.00%,0,0.00%,0,0.00%,0,0.00%,0
560,2760.0,150,101,67.33%,93,62.00%,101,67.33%,0,0.00%,8
561,9999.0,4,0,0.00%,0,0.00%,0,0.00%,0,0.00%,0
562,2766.0,258,190,73.64%,190,73.64%,191,74.03%,1,0.39%,0
563,9999.0,2,0,0.00%,0,0.00%,0,0.00%,0,0.00%,0
564,2794.0,549,359,65.39%,351,63.93%,376,68.49%,17,3.10%,8
565,2795.0,405,301,74.32%,293,72.35%,316,78.02%,15,3.70%,8
566,9999.0,169,74,43.79%,69,40.83%,87,51.48%,13,7.69%,5
567,2798.0,101,74,73.27%,72,71.29%,76,75.25%,2,1.98%,2
568,9999.0,2,1,50.00%,1,50.00%,1,50.00%,0,0.00%,0
569,2809.0,644,515,79.97%,508,78.88%,520,80.75%,5,0.78%,7
570,7629.0,41,37,90.24%,37,90.24%,37,90.24%,0,0.00%,0
571,2818.0,128,77,60.16%,75,58.59%,79,61.72%,2,1.56%,2
572,9999.0,2,0,0.00%,0,0.00%,0,0.00%,0,0.00%,0
573,2821.0,171,136,79.53%,135,78.95%,136,79.53%,0,0.00%,1
574,9999.0,5,0,0.00%,0,0.00%,0,0.00%,0,0.00%,0
575,2829.0,795,666,83.77%,664,83.52%,676,85.03%,10,1.26%,2
576,2833.0,137,115,83.94%,115,83.94%,117,85.40%,2,1.46%,0
577,9999.0,2,2,100.00%,2,100.00%,2,100.00%,0,0.00%,0
578,2839.0,265,213,80.38%,212,80.00%,215,81.13%,2,0.75%,1
579,9999.0,1,0,0.00%,0,0.00%,0,0.00%,0,0.00%,0
580,2848.0,362,290,80.11%,289,79.83%,292,80.66%,2,0.55%,1
581,9999.0,8,0,0.00%,0,0.00%,0,0.00%,0,0.00%,0
582,8125.0,52,51,98.08%,51,98.08%,51,98.08%,0,0.00%,0
583,2860.0,205,171,83.41%,171,83.41%,173,84.39%,2,0.98%,0
584,9999.0,3,0,0.00%,0,0.00%,0,0.00%,0,0.00%,0
585,2869.0,205,160,78.05%,160,78.05%,160,78.05%,0,0.00%,0
586,5242.0,147,101,68.71%,101,68.71%,101,68.71%,0,0.00%,0
587,9999.0,6,0,0.00%,0,0.00%,0,0.00%,0,0.00%,0
588,2891.0,133,106,79.70%,106,79.70%,109,81.95%,3,2.26%,0
589,9999.0,7,0,0.00%,0,0.00%,0,0.00%,0,0.00%,0
590,7348.0,680,455,66.91%,438,64.41%,462,67.94%,7,1.03%,17
591,9999.0,1,0,0.00%,0,0.00%,0,0.00%,0,0.00%,0
592,2924.0,162,123,75.93%,123,75.93%,130,80.25%,7,4.32%,0
593,2958.0,63,44,69.84%,44,69.84%,47,74.60%,3,4.76%,0
594,9999.0,2,0,0.00%,0,0.00%,2,100.00%,2,100.00%,0
595,5058.0,232,188,81.03%,188,81.03%,195,84.05%,7,3.02%,0
596,5059.0,93,44,47.31%,44,47.31%,46,49.46%,2,2.15%,0
597,3007.0,213,12,5.63%,12,5.63%,12,5.63%,0,0.00%,0
598,3008.0,128,92,71.88%,92,71.88%,93,72.66%,1,0.78%,0
599,3009.0,140,112,80.00%,112,80.00%,113,80.71%,1,0.71%,0
600,9999.0,27,2,7.41%,2,7.41%,3,11.11%,1,3.70%,0
601,6390.0,184,153,83.15%,150,81.52%,153,83.15%,0,0.00%,3
602,9999.0,6,0,0.00%,0,0.00%,0,0.00%,0,0.00%,0
603,6391.0,323,255,78.95%,250,77.40%,256,79.26%,1,0.31%,5
604,9999.0,5,0,0.00%,0,0.00%,0,0.00%,0,0.00%,0
605,6364.0,115,82,71.30%,82,71.30%,84,73.04%,2,1.74%,0
606,9999.0,1,0,0.00%,0,0.00%,0,0.00%,0,0.00%,0
607,3034.0,166,99,59.64%,92,55.42%,101,60.84%,2,1.20%,7
608,9999.0,1,0,0.00%,0,0.00%,0,0.00%,0,0.00%,0
609,4828.0,100,73,73.00%,73,73.00%,73,73.00%,0,0.00%,0
610,3040.0,53,36,67.92%,32,60.38%,36,67.92%,0,0.00%,4
611,3045.0,130,88,67.69%,88,67.69%,88,67.69%,0,0.00%,0
612,9999.0,1,0,0.00%,0,0.00%,0,0.00%,0,0.00%,0
613,3048.0,77,58,75.32%,54,70.13%,58,75.32%,0,0.00%,4
614,9999.0,1,1,100.00%,1,100.00%,1,100.00%,0,0.00%,0
615,3056.0,83,51,61.45%,50,60.24%,53,63.86%,2,2.41%,1
616,9999.0,1,0,0.00%,0,0.00%,0,0.00%,0,0.00%,0
617,6368.0,335,198,59.10%,198,59.10%,198,59.10%,0,0.00%,0
618,9999.0,2,1,50.00%,1,50.00%,1,50.00%,0,0.00%,0
619,4691.0,176,127,72.16%,117,66.48%,132,75.00%,5,2.84%,10
620,9999.0,1,0,0.00%,0,0.00%,0,0.00%,0,0.00%,0
621,5245.0,89,50,56.18%,50,56.18%,53,59.55%,3,3.37%,0
622,3107.0,52,35,67.31%,35,67.31%,37,71.15%,2,3.85%,0
623,3111.0,65,34,52.31%,34,52.31%,39,60.00%,5,7.69%,0
624,3117.0,64,28,43.75%,27,42.19%,37,57.81%,9,14.06%,1
625,6122.0,31,20,64.52%,13,41.94%,21,67.74%,1,3.23%,7
626,9999.0,1,0,0.00%,0,0.00%,0,0.00%,0,0.00%,0
627,5248.0,54,38,70.37%,34,62.96%,42,77.78%,4,7.41%,4
628,3137.0,104,69,66.35%,66,63.46%,79,75.96%,10,9.62%,3
629,7506.0,35,4,11.43%,4,11.43%,5,14.29%,1,2.86%,0
630,3145.0,147,113,76.87%,111,75.51%,124,84.35%,11,7.48%,2
631,6125.0,35,16,45.71%,11,31.43%,17,48.57%,1,2.86%,5
632,3150.0,143,104,72.73%,100,69.93%,104,72.73%,0,0.00%,4
633,6126.0,45,29,64.44%,25,55.56%,30,66.67%,1,2.22%,4
634,3155.0,95,61,64.21%,61,64.21%,61,64.21%,0,0.00%,0
635,3158.0,86,59,68.60%,55,63.95%,61,70.93%,2,2.33%,4
636,3165.0,79,48,60.76%,48,60.76%,54,68.35%,6,7.59%,0
637,9999.0,2,0,0.00%,0,0.00%,0,0.00%,0,0.00%,0
638,8093.0,114,78,68.42%,78,68.42%,78,68.42%,0,0.00%,0
639,3124.0,102,71,69.61%,69,67.65%,71,69.61%,0,0.00%,2
640,9999.0,1,0,0.00%,0,0.00%,0,0.00%,0,0.00%,0
641,6129.0,81,38,46.91%,36,44.44%,38,46.91%,0,0.00%,2
642,9999.0,1,0,0.00%,0,0.00%,0,0.00%,0,0.00%,0
643,8187.0,353,186,52.69%,162,45.89%,200,56.66%,14,3.97%,24
644,7866.0,15,13,86.67%,13,86.67%,13,86.67%,0,0.00%,0
645,6935.0,305,229,75.08%,219,71.80%,235,77.05%,6,1.97%,10
646,7641.0,229,118,51.53%,118,51.53%,120,52.40%,2,0.87%,0
647,3210.0,415,332,80.00%,318,76.63%,336,80.96%,4,0.96%,14
648,3216.0,412,293,71.12%,283,68.69%,296,71.84%,3,0.73%,10
649,7738.0,438,297,67.81%,296,67.58%,302,68.95%,5,1.14%,1
650,9999.0,6,2,33.33%,2,33.33%,2,33.33%,0,0.00%,0
651,3224.0,405,225,55.56%,225,55.56%,227,56.05%,2,0.49%,0
652,9999.0,7,0,0.00%,0,0.00%,0,0.00%,0,0.00%,0
653,7687.0,163,93,57.06%,93,57.06%,101,61.96%,8,4.91%,0
654,9999.0,1,0,0.00%,0,0.00%,0,0.00%,0,0.00%,0
655,3241.0,543,447,82.32%,445,81.95%,454,83.61%,7,1.29%,2
656,9999.0,2,0,0.00%,0,0.00%,0,0.00%,0,0.00%,0
657,3260.0,376,308,81.91%,303,80.59%,311,82.71%,3,0.80%,5
658,9999.0,7,0,0.00%,0,0.00%,0,0.00%,0,0.00%,0
659,3333.0,362,321,88.67%,321,88.67%,328,90.61%,7,1.93%,0
660,9999.0,5,0,0.00%,0,0.00%,0,0.00%,0,0.00%,0
661,3272.0,398,363,91.21%,362,90.95%,366,91.96%,3,0.75%,1
662,9999.0,8,1,12.50%,1,12.50%,1,12.50%,0,0.00%,0
663,8049.0,42,40,95.24%,40,95.24%,40,95.24%,0,0.00%,0
664,9999.0,1,0,0.00%,0,0.00%,0,0.00%,0,0.00%,0
665,3295.0,328,308,93.90%,307,93.60%,310,94.51%,2,0.61%,1
666,3296.0,291,274,94.16%,274,94.16%,279,95.88%,5,1.72%,0
667,9999.0,4,1,25.00%,0,0.00%,1,25.00%,0,0.00%,1
668,4960.0,200,193,96.50%,192,96.00%,193,96.50%,0,0.00%,1
669,3305.0,398,360,90.45%,360,90.45%,360,90.45%,0,0.00%,0
670,9999.0,4,0,0.00%,0,0.00%,0,0.00%,0,0.00%,0
671,6729.0,304,247,81.25%,239,78.62%,247,81.25%,0,0.00%,8
672,6998.0,88,52,59.09%,45,51.14%,52,59.09%,0,0.00%,7
673,9999.0,13,0,0.00%,0,0.00%,0,0.00%,0,0.00%,0
674,5345.0,"1,047",926,88.44%,922,88.06%,942,89.97%,16,1.53%,4
675,9999.0,18,6,33.33%,5,27.78%,7,38.89%,1,5.56%,1
676,3328.0,455,386,84.84%,382,83.96%,390,85.71%,4,0.88%,4
677,9999.0,3,0,0.00%,0,0.00%,0,0.00%,0,0.00%,0
678,3338.0,249,157,63.05%,155,62.25%,164,65.86%,7,2.81%,2
679,3348.0,123,91,73.98%,80,65.04%,91,73.98%,0,0.00%,11
680,3354.0,556,443,79.68%,441,79.32%,444,79.86%,1,0.18%,2
681,9999.0,15,2,13.33%,2,13.33%,3,20.00%,1,6.67%,0
682,3376.0,158,131,82.91%,131,82.91%,132,83.54%,1,0.63%,0
683,3367.0,561,492,87.70%,492,87.70%,499,88.95%,7,1.25%,0
684,9999.0,5,0,0.00%,0,0.00%,0,0.00%,0,0.00%,0
685,5078.0,325,297,91.38%,297,91.38%,302,92.92%,5,1.54%,0
686,9999.0,3,0,0.00%,0,0.00%,0,0.00%,0,0.00%,0
687,3395.0,276,247,89.49%,245,88.77%,247,89.49%,0,0.00%,2
688,9999.0,24,11,45.83%,11,45.83%,11,45.83%,0,0.00%,0
689,3401.0,239,189,79.08%,189,79.08%,192,80.33%,3,1.26%,0
690,9999.0,4,0,0.00%,0,0.00%,0,0.00%,0,0.00%,0
691,5081.0,201,134,66.67%,130,64.68%,135,67.16%,1,0.50%,4
692,9999.0,4,2,50.00%,2,50.00%,2,50.00%,0,0.00%,0
693,3247.0,318,296,93.08%,296,93.08%,298,93.71%,2,0.63%,0
694,9999.0,11,3,27.27%,3,27.27%,3,27.27%,0,0.00%,0
695,7858.0,734,369,50.27%,345,47.00%,433,58.99%,64,8.72%,24
696,3425.0,160,116,72.50%,116,72.50%,122,76.25%,6,3.75%,0
697,7681.0,59,55,93.22%,53,89.83%,56,94.92%,1,1.69%,2
698,3434.0,246,185,75.20%,185,75.20%,185,75.20%,0,0.00%,0
699,3465.0,639,498,77.93%,487,76.21%,501,78.40%,3,0.47%,11
700,4957.0,431,346,80.28%,340,78.89%,349,80.97%,3,0.70%,6
701,9999.0,13,0,0.00%,0,0.00%,0,0.00%,0,0.00%,0
702,7634.0,117,101,86.32%,101,86.32%,102,87.18%,1,0.85%,0
703,3482.0,667,548,82.16%,545,81.71%,561,84.11%,13,1.95%,3
704,3495.0,363,310,85.40%,309,85.12%,314,86.50%,4,1.10%,1
705,9999.0,3,0,0.00%,0,0.00%,0,0.00%,0,0.00%,0
706,3505.0,396,321,81.06%,316,79.80%,328,82.83%,7,1.77%,5
707,9999.0,1,0,0.00%,0,0.00%,0,0.00%,0,0.00%,0
708,6439.0,133,88,66.17%,86,64.66%,91,68.42%,3,2.26%,2
709,5352.0,170,139,81.76%,138,81.18%,140,82.35%,1,0.59%,1
710,3522.0,155,119,76.77%,118,76.13%,121,78.06%,2,1.29%,1
711,9999.0,4,2,50.00%,2,50.00%,3,75.00%,1,25.00%,0
712,3532.0,89,52,58.43%,49,55.06%,53,59.55%,1,1.12%,3
713,9999.0,1,0,0.00%,0,0.00%,0,0.00%,0,0.00%,0
714,3541.0,153,95,62.09%,90,58.82%,95,62.09%,0,0.00%,5
715,9999.0,1,0,0.00%,0,0.00%,0,0.00%,0,0.00%,0
716,6936.0,114,60,52.63%,58,50.88%,64,56.14%,4,3.51%,2
717,7893.0,162,103,63.58%,97,59.88%,105,64.81%,2,1.23%,6
718,3569.0,148,78,52.70%,75,50.68%,79,53.38%,1,0.68%,3
719,5103.0,102,64,62.75%,61,59.80%,64,62.75%,0,0.00%,3
720,6341.0,59,45,76.27%,45,76.27%,45,76.27%,0,0.00%,0
721,7930.0,63,35,55.56%,35,55.56%,39,61.90%,4,6.35%,0
722,3589.0,135,61,45.19%,60,44.44%,61,45.19%,0,0.00%,1
723,3596.0,191,115,60.21%,115,60.21%,119,62.30%,4,2.09%,0
724,9999.0,3,0,0.00%,0,0.00%,0,0.00%,0,0.00%,0
725,7744.0,77,49,63.64%,49,63.64%,55,71.43%,6,7.79%,0
726,8083.0,42,42,100.00%,42,100.00%,42,100.00%,0,0.00%,0
727,7678.0,76,69,90.79%,69,90.79%,70,92.11%,1,1.32%,0
728,7737.0,128,85,66.41%,85,66.41%,93,72.66%,8,6.25%,0
729,7777.0,53,37,69.81%,37,69.81%,40,75.47%,3,5.66%,0
730,7909.0,116,101,87.07%,100,86.21%,104,89.66%,3,2.59%,1
731,7910.0,76,65,85.53%,65,85.53%,68,89.47%,3,3.95%,0
732,8216.0,27,24,88.89%,24,88.89%,26,96.30%,2,7.41%,0
733,7510.0,128,92,71.88%,92,71.88%,100,78.13%,8,6.25%,0
734,7513.0,131,13,9.92%,13,9.92%,15,11.45%,2,1.53%,0
735,7540.0,112,72,64.29%,72,64.29%,74,66.07%,2,1.79%,0
736,7542.0,114,0,0.00%,0,0.00%,0,0.00%,0,0.00%,0
737,7546.0,52,47,90.38%,45,86.54%,47,90.38%,0,0.00%,2
738,7574.0,100,96,96.00%,96,96.00%,97,97.00%,1,1.00%,0
739,7578.0,110,101,91.82%,100,90.91%,103,93.64%,2,1.82%,1
740,7582.0,77,73,94.81%,73,94.81%,77,100.00%,4,5.19%,0
741,7586.0,99,86,86.87%,86,86.87%,92,92.93%,6,6.06%,0
742,7587.0,105,82,78.10%,82,78.10%,90,85.71%,8,7.62%,0
743,7588.0,79,59,74.68%,58,73.42%,68,86.08%,9,11.39%,1
744,7647.0,188,0,0.00%,0,0.00%,0,0.00%,0,0.00%,0
745,7649.0,159,152,95.60%,152,95.60%,156,98.11%,4,2.52%,0
746,7665.0,174,105,60.34%,104,59.77%,115,66.09%,10,5.75%,1
747,7666.0,309,253,81.88%,249,80.58%,259,83.82%,6,1.94%,4
748,8205.0,440,280,63.64%,274,62.27%,330,75.00%,50,11.36%,6
749,7672.0,123,97,78.86%,85,69.11%,97,78.86%,0,0.00%,12
750,8207.0,222,154,69.37%,145,65.32%,170,76.58%,16,7.21%,9
751,8217.0,24,0,0.00%,0,0.00%,0,0.00%,0,0.00%,0
752,8358.0,115,98,85.22%,97,84.35%,109,94.78%,11,9.57%,1
753,3728.0,10,0,0.00%,0,0.00%,0,0.00%,0,0.00%,0
754,3808.0,108,0,0.00%,0,0.00%,0,0.00%,0,0.00%,0
755,3816.0,212,0,0.00%,0,0.00%,0,0.00%,0,0.00%,0
756,3818.0,149,0,0.00%,0,0.00%,0,0.00%,0,0.00%,0
757,3841.0,99,0,0.00%,0,0.00%,0,0.00%,0,0.00%,0
758,3842.0,108,0,0.00%,0,0.00%,0,0.00%,0,0.00%,0
759,3843.0,203,0,0.00%,0,0.00%,0,0.00%,0,0.00%,0
760,3844.0,118,0,0.00%,0,0.00%,0,0.00%,0,0.00%,0
761,3845.0,273,0,0.00%,0,0.00%,0,0.00%,0,0.00%,0
762,3847.0,145,0,0.00%,0,0.00%,0,0.00%,0,0.00%,0
763,3848.0,533,0,0.00%,0,0.00%,0,0.00%,0,0.00%,0
764,3849.0,188,0,0.00%,0,0.00%,0,0.00%,0,0.00%,0
765,3850.0,236,0,0.00%,0,0.00%,0,0.00%,0,0.00%,0
766,3851.0,72,0,0.00%,0,0.00%,0,0.00%,0,0.00%,0
767,3855.0,631,0,0.00%,0,0.00%,0,0.00%,0,0.00%,0
768,3857.0,109,0,0.00%,0,0.00%,0,0.00%,0,0.00%,0
769,3859.0,114,0,0.00%,0,0.00%,0,0.00%,0,0.00%,0
770,3860.0,81,0,0.00%,0,0.00%,0,0.00%,0,0.00%,0
771,3861.0,134,0,0.00%,0,0.00%,0,0.00%,0,0.00%,0
772,6527.0,261,0,0.00%,0,0.00%,0,0.00%,0,0.00%,0
773,6548.0,61,0,0.00%,0,0.00%,0,0.00%,0,0.00%,0
774,6675.0,155,0,0.00%,0,0.00%,0,0.00%,0,0.00%,0
775,6822.0,172,0,0.00%,0,0.00%,0,0.00%,0,0.00%,0
776,6996.0,159,0,0.00%,0,0.00%,0,0.00%,0,0.00%,0
777,7023.0,176,0,0.00%,0,0.00%,0,0.00%,0,0.00%,0
778,7070.0,102,0,0.00%,0,0.00%,0,0.00%,0,0.00%,0
779,7072.0,132,0,0.00%,0,0.00%,0,0.00%,0,0.00%,0
780,7229.0,43,0,0.00%,0,0.00%,0,0.00%,0,0.00%,0
781,7245.0,95,0,0.00%,0,0.00%,0,0.00%,0,0.00%,0
782,7255.0,73,0,0.00%,0,0.00%,0,0.00%,0,0.00%,0
783,7664.0,48,0,0.00%,0,0.00%,0,0.00%,0,0.00%,0
784,7780.0,74,0,0.00%,0,0.00%,0,0.00%,0,0.00%,0
785,7782.0,146,0,0.00%,0,0.00%,0,0.00%,0,0.00%,0
786,7808.0,49,0,0.00%,0,0.00%,0,0.00%,0,0.00%,0
787,7811.0,57,0,0.00%,0,0.00%,0,0.00%,0,0.00%,0
788,7813.0,103,0,0.00%,0,0.00%,0,0.00%,0,0.00%,0
789,7815.0,68,0,0.00%,0,0.00%,0,0.00%,0,0.00%,0
790,7850.0,63,0,0.00%,0,0.00%,0,0.00%,0,0.00%,0
791,7852.0,113,0,0.00%,0,0.00%,0,0.00%,0,0.00%,0
792,7855.0,79,0,0.00%,0,0.00%,0,0.00%,0,0.00%,0
793,7903.0,100,0,0.00%,0,0.00%,0,0.00%,0,0.00%,0
794,7904.0,199,0,0.00%,0,0.00%,0,0.00%,0,0.00%,0
795,7905.0,86,0,0.00%,0,0.00%,0,0.00%,0,0.00%,0
796,7906.0,117,0,0.00%,0,0.00%,0,0.00%,0,0.00%,0
797,8039.0,137,0,0.00%,0,0.00%,0,0.00%,0,0.00%,0
798,8293.0,54,0,0.00%,0,0.00%,0,0.00%,0,0.00%,0
799,8298.0,94,0,0.00%,0,0.00%,0,0.00%,0,0.00%,0
800,8328.0,33,0,0.00%,0,0.00%,0,0.00%,0,0.00%,0
801,8330.0,117,0,0.00%,0,0.00%,0,0.00%,0,0.00%,0
802,8385.0,19,0,0.00%,0,0.00%,0,0.00%,0,0.00%,0
803,8386.0,10,0,0.00%,0,0.00%,0,0.00%,0,0.00%,0
804,8388.0,122,0,0.00%,0,0.00%,0,0.00%,0,0.00%,0
805,9999.0,880,0,0.00%,0,0.00%,0,0.00%,0,0.00%,0
806,8195.0,137,0,0.00%,0,0.00%,0,0.00%,0,0.00%,0
807,7961.0,101,76,75.25%,75,74.26%,85,84.16%,9,8.91%,1
808,8127.0,50,50,100.00%,49,98.00%,50,100.00%,0,0.00%,1
809,8148.0,36,26,72.22%,26,72.22%,27,75.00%,1,2.78%,0
810,7981.0,81,78,96.30%,75,92.59%,78,96.30%,0,0.00%,3
811,8126.0,77,63,81.82%,62,80.52%,64,83.12%,1,1.30%,1
812,4310.0,256,160,62.50%,158,61.72%,170,66.41%,10,3.91%,2
813,9999.0,3,0,0.00%,0,0.00%,0,0.00%,0,0.00%,0
814,5261.0,377,284,75.33%,283,75.07%,291,77.19%,7,1.86%,1
815,6222.0,13,6,46.15%,6,46.15%,6,46.15%,0,0.00%,0
816,3869.0,77,49,63.64%,49,63.64%,49,63.64%,0,0.00%,0
817,6223.0,15,12,80.00%,9,60.00%,12,80.00%,0,0.00%,3
818,3875.0,44,17,38.64%,15,34.09%,17,38.64%,0,0.00%,2
819,3877.0,30,17,56.67%,17,56.67%,19,63.33%,2,6.67%,0
820,9999.0,1,1,100.00%,1,100.00%,1,100.00%,0,0.00%,0
821,3891.0,189,131,69.31%,112,59.26%,136,71.96%,5,2.65%,19
822,9999.0,1,0,0.00%,0,0.00%,0,0.00%,0,0.00%,0
823,7012.0,61,43,70.49%,38,62.30%,43,70.49%,0,0.00%,5
824,9999.0,2,0,0.00%,0,0.00%,0,0.00%,0,0.00%,0
825,6583.0,103,68,66.02%,57,55.34%,71,68.93%,3,2.91%,11
826,9999.0,1,0,0.00%,0,0.00%,0,0.00%,0,0.00%,0
827,8161.0,15,4,26.67%,4,26.67%,4,26.67%,0,0.00%,0
828,3883.0,129,79,61.24%,79,61.24%,82,63.57%,3,2.33%,0
829,3910.0,111,59,53.15%,59,53.15%,63,56.76%,4,3.60%,0
830,3924.0,199,119,59.80%,110,55.28%,120,60.30%,1,0.50%,9
831,9999.0,3,0,0.00%,0,0.00%,0,0.00%,0,0.00%,0
832,9999.0,12,0,0.00%,0,0.00%,0,0.00%,0,0.00%,0
833,3940.0,69,37,53.62%,37,53.62%,37,53.62%,0,0.00%,0
834,5264.0,95,62,65.26%,62,65.26%,69,72.63%,7,7.37%,0
835,9999.0,1,0,0.00%,0,0.00%,0,0.00%,0,0.00%,0
836,5070.0,155,124,80.00%,119,76.77%,129,83.23%,5,3.23%,5
837,3957.0,61,45,73.77%,42,68.85%,45,73.77%,0,0.00%,3
838,3914.0,64,44,68.75%,37,57.81%,45,70.31%,1,1.56%,7
839,3962.0,139,66,47.48%,66,47.48%,66,47.48%,0,0.00%,0
840,9999.0,5,0,0.00%,0,0.00%,0,0.00%,0,0.00%,0
841,3969.0,181,125,69.06%,125,69.06%,125,69.06%,0,0.00%,0
842,6207.0,61,37,60.66%,37,60.66%,37,60.66%,0,0.00%,0
843,3978.0,67,48,71.64%,48,71.64%,49,73.13%,1,1.49%,0
844,3994.0,67,45,67.16%,45,67.16%,46,68.66%,1,1.49%,0
845,3988.0,72,40,55.56%,36,50.00%,43,59.72%,3,4.17%,4
846,6210.0,55,37,67.27%,32,58.18%,37,67.27%,0,0.00%,5
847,4002.0,21,12,57.14%,12,57.14%,13,61.90%,1,4.76%,0
848,9999.0,1,0,0.00%,0,0.00%,0,0.00%,0,0.00%,0
849,4006.0,49,25,51.02%,25,51.02%,26,53.06%,1,2.04%,0
850,6800.0,27,17,62.96%,17,62.96%,17,62.96%,0,0.00%,0
851,8274.0,180,103,57.22%,99,55.00%,104,57.78%,1,0.56%,4
852,6216.0,23,15,65.22%,11,47.83%,15,65.22%,0,0.00%,4
853,9999.0,1,0,0.00%,0,0.00%,0,0.00%,0,0.00%,0
854,4026.0,62,45,72.58%,45,72.58%,49,79.03%,4,6.45%,0
855,9999.0,1,0,0.00%,0,0.00%,0,0.00%,0,0.00%,0
856,4030.0,49,23,46.94%,23,46.94%,27,55.10%,4,8.16%,0
857,4034.0,77,48,62.34%,48,62.34%,48,62.34%,0,0.00%,0
858,6418.0,75,43,57.33%,43,57.33%,48,64.00%,5,6.67%,0
859,6419.0,57,33,57.89%,31,54.39%,36,63.16%,3,5.26%,2
860,4044.0,118,60,50.85%,59,50.00%,60,50.85%,0,0.00%,1
861,4049.0,77,46,59.74%,46,59.74%,50,64.94%,4,5.19%,0
862,4054.0,51,35,68.63%,31,60.78%,36,70.59%,1,1.96%,4
863,9999.0,4,0,0.00%,0,0.00%,0,0.00%,0,0.00%,0
864,4058.0,60,34,56.67%,33,55.00%,34,56.67%,0,0.00%,1
865,6373.0,80,51,63.75%,51,63.75%,53,66.25%,2,2.50%,0
866,4064.0,42,27,64.29%,27,64.29%,29,69.05%,2,4.76%,0
867,4068.0,95,52,54.74%,52,54.74%,60,63.16%,8,8.42%,0
868,4080.0,94,51,54.26%,50,53.19%,51,54.26%,0,0.00%,1
869,4085.0,144,116,80.56%,116,80.56%,117,81.25%,1,0.69%,0
870,9999.0,3,0,0.00%,0,0.00%,0,0.00%,0,0.00%,0
871,4091.0,164,88,53.66%,87,53.05%,93,56.71%,5,3.05%,1
872,4098.0,82,51,62.20%,49,59.76%,58,70.73%,7,8.54%,2
873,4106.0,147,82,55.78%,82,55.78%,92,62.59%,10,6.80%,0
874,9999.0,31,0,0.00%,0,0.00%,0,0.00%,0,0.00%,0
875,4931.0,153,92,60.13%,81,52.94%,100,65.36%,8,5.23%,11
876,9999.0,11,0,0.00%,0,0.00%,0,0.00%,0,0.00%,0
877,1668.0,135,65,48.15%,61,45.19%,77,57.04%,12,8.89%,4
878,9999.0,6,0,0.00%,0,0.00%,0,0.00%,0,0.00%,0
879,4126.0,66,35,53.03%,30,45.45%,42,63.64%,7,10.61%,5
880,7833.0,19,13,68.42%,12,63.16%,15,78.95%,2,10.53%,1
881,4135.0,71,29,40.85%,26,36.62%,30,42.25%,1,1.41%,3
882,4143.0,77,62,80.52%,59,76.62%,62,80.52%,0,0.00%,3
883,4146.0,44,17,38.64%,17,38.64%,18,40.91%,1,2.27%,0
884,4149.0,162,101,62.35%,95,58.64%,108,66.67%,7,4.32%,6
885,4165.0,36,27,75.00%,24,66.67%,28,77.78%,1,2.78%,3
886,9999.0,1,0,0.00%,0,0.00%,0,0.00%,0,0.00%,0
887,4188.0,71,49,69.01%,41,57.75%,52,73.24%,3,4.23%,8
888,9999.0,2,0,0.00%,0,0.00%,0,0.00%,0,0.00%,0
889,4181.0,97,62,63.92%,48,49.48%,62,63.92%,0,0.00%,14
890,4195.0,82,50,60.98%,50,60.98%,51,62.20%,1,1.22%,0
891,9999.0,4,0,0.00%,0,0.00%,0,0.00%,0,0.00%,0
892,4203.0,69,58,84.06%,58,84.06%,62,89.86%,4,5.80%,0
893,4217.0,361,296,81.99%,276,76.45%,299,82.83%,3,0.83%,20
894,9999.0,3,0,0.00%,0,0.00%,0,0.00%,0,0.00%,0
895,4715.0,113,79,69.91%,75,66.37%,79,69.91%,0,0.00%,4
896,9999.0,2,1,50.00%,1,50.00%,1,50.00%,0,0.00%,0
897,4235.0,66,51,77.27%,51,77.27%,51,77.27%,0,0.00%,0
898,4242.0,69,46,66.67%,46,66.67%,46,66.67%,0,0.00%,0
899,9999.0,3,0,0.00%,0,0.00%,0,0.00%,0,0.00%,0
900,4249.0,146,88,60.27%,86,58.90%,88,60.27%,0,0.00%,2
901,9999.0,1,0,0.00%,0,0.00%,0,0.00%,0,0.00%,0
902,5083.0,338,320,94.67%,320,94.67%,321,94.97%,1,0.30%,0
903,9999.0,2,0,0.00%,0,0.00%,0,0.00%,0,0.00%,0
904,7019.0,182,101,55.49%,96,52.75%,113,62.09%,12,6.59%,5
905,9999.0,11,0,0.00%,0,0.00%,0,0.00%,0,0.00%,0
906,6012.0,253,165,65.22%,162,64.03%,172,67.98%,7,2.77%,3
907,4286.0,88,48,54.55%,45,51.14%,51,57.95%,3,3.41%,3
908,9999.0,2,0,0.00%,0,0.00%,0,0.00%,0,0.00%,0
909,4295.0,195,127,65.13%,126,64.62%,131,67.18%,4,2.05%,1
910,9999.0,14,8,57.14%,8,57.14%,9,64.29%,1,7.14%,0
911,6704.0,146,94,64.38%,89,60.96%,96,65.75%,2,1.37%,5
912,9999.0,1,0,0.00%,0,0.00%,0,0.00%,0,0.00%,0
913,4930.0,187,143,76.47%,136,72.73%,146,78.07%,3,1.60%,7
914,4340.0,140,107,76.43%,102,72.86%,109,77.86%,2,1.43%,5
915,9999.0,3,1,33.33%,1,33.33%,1,33.33%,0,0.00%,0
916,4352.0,178,138,77.53%,130,73.03%,139,78.09%,1,0.56%,8
917,9999.0,10,0,0.00%,0,0.00%,0,0.00%,0,0.00%,0
918,4360.0,306,273,89.22%,271,88.56%,273,89.22%,0,0.00%,2
919,7550.0,49,21,42.86%,20,40.82%,23,46.94%,2,4.08%,1
920,4845.0,336,259,77.08%,254,75.60%,266,79.17%,7,2.08%,5
921,9999.0,5,0,0.00%,0,0.00%,0,0.00%,0,0.00%,0
922,4373.0,189,154,81.48%,147,77.78%,154,81.48%,0,0.00%,7
923,9999.0,6,0,0.00%,0,0.00%,0,0.00%,0,0.00%,0
924,4404.0,448,364,81.25%,358,79.91%,369,82.37%,5,1.12%,6
925,9999.0,7,0,0.00%,0,0.00%,0,0.00%,0,0.00%,0
926,4412.0,61,44,72.13%,43,70.49%,44,72.13%,0,0.00%,1
927,9999.0,3,0,0.00%,0,0.00%,0,0.00%,0,0.00%,0
928,4431.0,299,194,64.88%,177,59.20%,198,66.22%,4,1.34%,17
929,9999.0,1,0,0.00%,0,0.00%,0,0.00%,0,0.00%,0
930,4442.0,115,83,72.17%,79,68.70%,92,80.00%,9,7.83%,4
931,9999.0,2,0,0.00%,0,0.00%,0,0.00%,0,0.00%,0
932,6181.0,53,34,64.15%,29,54.72%,35,66.04%,1,1.89%,5
933,4458.0,155,0,0.00%,0,0.00%,0,0.00%,0,0.00%,0
934,9999.0,5,0,0.00%,0,0.00%,0,0.00%,0,0.00%,0
935,8323.0,118,96,81.36%,90,76.27%,98,83.05%,2,1.69%,6
936,4717.0,412,335,81.31%,329,79.85%,340,82.52%,5,1.21%,6
937,9999.0,4,0,0.00%,0,0.00%,0,0.00%,0,0.00%,0
938,6648.0,335,297,88.66%,288,85.97%,304,90.75%,7,2.09%,9
939,9999.0,1,0,0.00%,0,0.00%,0,0.00%,0,0.00%,0
940,6191.0,141,88,62.41%,88,62.41%,98,69.50%,10,7.09%,0
941,4735.0,173,134,77.46%,113,65.32%,134,77.46%,0,0.00%,21
942,9999.0,4,0,0.00%,0,0.00%,0,0.00%,0,0.00%,0
943,5271.0,185,124,67.03%,116,62.70%,124,67.03%,0,0.00%,8
944,4528.0,84,54,64.29%,54,64.29%,60,71.43%,6,7.14%,0
945,9999.0,2,1,50.00%,1,50.00%,1,50.00%,0,0.00%,0
946,4545.0,403,309,76.67%,297,73.70%,316,78.41%,7,1.74%,12
947,9999.0,3,0,0.00%,0,0.00%,0,0.00%,0,0.00%,0
948,4553.0,435,349,80.23%,344,79.08%,360,82.76%,11,2.53%,5
949,9999.0,22,7,31.82%,7,31.82%,8,36.36%,1,4.55%,0
950,4558.0,212,121,57.08%,114,53.77%,126,59.43%,5,2.36%,7
951,9999.0,4,0,0.00%,0,0.00%,0,0.00%,0,0.00%,0
952,4564.0,157,103,65.61%,100,63.69%,114,72.61%,11,7.01%,3
953,9999.0,4,0,0.00%,0,0.00%,0,0.00%,0,0.00%,0
954,4571.0,104,53,50.96%,51,49.04%,57,54.81%,4,3.85%,2
955,7624.0,74,3,4.05%,0,0.00%,3,4.05%,0,0.00%,3
956,4577.0,221,142,64.25%,138,62.44%,146,66.06%,4,1.81%,4
957,9999.0,5,0,0.00%,0,0.00%,0,0.00%,0,0.00%,0
958,4598.0,382,311,81.41%,291,76.18%,369,96.60%,58,15.18%,20
959,9999.0,7,0,0.00%,0,0.00%,0,0.00%,0,0.00%,0
960,4602.0,170,111,65.29%,103,60.59%,113,66.47%,2,1.18%,8
961,9999.0,18,2,11.11%,2,11.11%,3,16.67%,1,5.56%,0
962,4608.0,254,170,66.93%,165,64.96%,179,70.47%,9,3.54%,5
963,9999.0,25,0,0.00%,0,0.00%,0,0.00%,0,0.00%,0
964,4614.0,216,167,77.31%,159,73.61%,169,78.24%,2,0.93%,8
965,4623.0,254,168,66.14%,157,61.81%,172,67.72%,4,1.57%,11
966,9999.0,4,0,0.00%,0,0.00%,0,0.00%,0,0.00%,0
967,6705.0,218,154,70.64%,149,68.35%,157,72.02%,3,1.38%,5
968,9999.0,11,7,63.64%,6,54.55%,10,90.91%,3,27.27%,1
969,4647.0,164,95,57.93%,92,56.10%,97,59.15%,2,1.22%,3
970,5168.0,366,128,34.97%,126,34.43%,137,37.43%,9,2.46%,2
971,4658.0,161,131,81.37%,131,81.37%,131,81.37%,0,0.00%,0
972,9999.0,13,6,46.15%,6,46.15%,7,53.85%,1,7.69%,0
973,1732.0,292,231,79.11%,226,77.40%,232,79.45%,1,0.34%,5
974,4704.0,258,182,70.54%,174,67.44%,183,70.93%,1,0.39%,8
975,9999.0,1,0,0.00%,0,0.00%,0,0.00%,0,0.00%,0
976,6345.0,236,160,67.80%,157,66.53%,165,69.92%,5,2.12%,3
977,9999.0,9,0,0.00%,0,0.00%,0,0.00%,0,0.00%,0
978,8041.0,54,36,66.67%,35,64.81%,40,74.07%,4,7.41%,1
979,,"125,505","83,027",66.15%,"80,584",64.21%,"85,573",68.18%,"2,546",2.03%,"2,443"
980,,,- 2 -,,,,,www.pimsreports.state.pa.us,,,
