,school number,graduate count,college bound,total college bound %,2- or 4-year college or university,2- or 4-year university %,total postsecondary bound,total postsecondary bound %,non-degree-granting postsecondary school,non-degree-granting postsecondary school %,specialized associate degree granting institution
0,3.0,159,82,51.57%,79,49.69%,84,52.83%,2,1.26%,3
1,9999.0,2,1,50.00%,1,50.00%,1,50.00%,0,0.00%,0
2,17.0,279,209,74.91%,194,69.53%,210,75.27%,1,0.36%,15
3,9999.0,2,0,0.00%,0,0.00%,0,0.00%,0,0.00%,0
4,6269.0,90,67,74.44%,67,74.44%,70,77.78%,3,3.33%,0
5,9999.0,1,0,0.00%,0,0.00%,0,0.00%,0,0.00%,0
6,6271.0,232,173,74.57%,161,69.40%,181,78.02%,8,3.45%,12
7,9999.0,7,0,0.00%,0,0.00%,0,0.00%,0,0.00%,0
8,14.0,130,80,61.54%,80,61.54%,81,62.31%,1,0.77%,0
9,9999.0,2,0,0.00%,0,0.00%,0,0.00%,0,0.00%,0
10,21.0,133,78,58.65%,78,58.65%,80,60.15%,2,1.50%,0
11,9999.0,2,0,0.00%,0,0.00%,0,0.00%,0,0.00%,0
12,7727.0,125,101,80.80%,99,79.20%,104,83.20%,3,2.40%,2
13,7846.0,20,10,50.00%,10,50.00%,14,70.00%,4,20.00%,0
14,7562.0,35,23,65.71%,22,62.86%,23,65.71%,0,0.00%,1
15,409.0,356,104,29.21%,104,29.21%,105,29.49%,1,0.28%,0
16,412.0,174,57,32.76%,54,31.03%,60,34.48%,3,1.72%,3
17,416.0,112,5,4.46%,4,3.57%,6,5.36%,1,0.89%,1
18,6047.0,14,0,0.00%,0,0.00%,0,0.00%,0,0.00%,0
19,6664.0,8,0,0.00%,0,0.00%,0,0.00%,0,0.00%,0
20,6811.0,10,0,0.00%,0,0.00%,0,0.00%,0,0.00%,0
21,6915.0,289,1,0.35%,1,0.35%,1,0.35%,0,0.00%,0
22,8105.0,115,81,70.43%,81,70.43%,81,70.43%,0,0.00%,0
23,8106.0,125,119,95.20%,119,95.20%,120,96.00%,1,0.80%,0
24,8107.0,76,4,5.26%,4,5.26%,4,5.26%,0,0.00%,0
25,8110.0,74,8,10.81%,7,9.46%,9,12.16%,1,1.35%,1
26,8203.0,88,3,3.41%,3,3.41%,3,3.41%,0,0.00%,0
27,8300.0,31,1,3.23%,1,3.23%,1,3.23%,0,0.00%,0
28,9999.0,4,0,0.00%,0,0.00%,0,0.00%,0,0.00%,0
29,7772.0,33,26,78.79%,26,78.79%,29,87.88%,3,9.09%,0
30,29.0,65,47,72.31%,47,72.31%,47,72.31%,0,0.00%,0
31,5199.0,122,117,95.90%,116,95.08%,117,95.90%,0,0.00%,1
32,9999.0,1,0,0.00%,0,0.00%,0,0.00%,0,0.00%,0
33,315.0,411,362,88.08%,362,88.08%,369,89.78%,7,1.70%,0
34,50.0,322,257,79.81%,251,77.95%,258,80.12%,1,0.31%,6
35,62.0,340,282,82.94%,282,82.94%,282,82.94%,0,0.00%,0
36,9999.0,2,0,0.00%,0,0.00%,0,0.00%,0,0.00%,0
37,70.0,74,26,35.14%,25,33.78%,26,35.14%,0,0.00%,1
38,9999.0,5,3,60.00%,3,60.00%,3,60.00%,0,0.00%,0
39,79.0,90,52,57.78%,51,56.67%,54,60.00%,2,2.22%,1
40,6706.0,237,182,76.79%,179,75.53%,187,78.90%,5,2.11%,3
41,9999.0,4,0,0.00%,0,0.00%,0,0.00%,0,0.00%,0
42,8094.0,43,23,53.49%,19,44.19%,23,53.49%,0,0.00%,4
43,9999.0,2,0,0.00%,0,0.00%,0,0.00%,0,0.00%,0
44,8087.0,38,26,68.42%,26,68.42%,27,71.05%,1,2.63%,0
45,513.0,130,88,67.69%,88,67.69%,98,75.38%,10,7.69%,0
46,9999.0,2,0,0.00%,0,0.00%,0,0.00%,0,0.00%,0
47,8340.0,108,70,64.81%,70,64.81%,70,64.81%,0,0.00%,0
48,9999.0,2,0,0.00%,0,0.00%,0,0.00%,0,0.00%,0
49,144.0,188,123,65.43%,119,63.30%,127,67.55%,4,2.13%,4
50,9999.0,2,0,0.00%,0,0.00%,0,0.00%,0,0.00%,0
51,7648.0,1,0,0.00%,0,0.00%,0,0.00%,0,0.00%,0
52,9999.0,1,0,0.00%,0,0.00%,0,0.00%,0,0.00%,0
53,156.0,325,287,88.31%,280,86.15%,288,88.62%,1,0.31%,7
54,170.0,258,187,72.48%,180,69.77%,190,73.64%,3,1.16%,7
55,9999.0,2,1,50.00%,1,50.00%,1,50.00%,0,0.00%,0
56,5190.0,253,224,88.54%,224,88.54%,224,88.54%,0,0.00%,0
57,5153.0,164,99,60.37%,88,53.66%,100,60.98%,1,0.61%,11
58,9999.0,5,0,0.00%,0,0.00%,0,0.00%,0,0.00%,0
59,5112.0,150,120,80.00%,114,76.00%,124,82.67%,4,2.67%,6
60,9999.0,3,0,0.00%,0,0.00%,0,0.00%,0,0.00%,0
61,6105.0,196,113,57.65%,107,54.59%,121,61.73%,8,4.08%,6
62,5017.0,220,174,79.09%,174,79.09%,178,80.91%,4,1.82%,0
63,9999.0,3,0,0.00%,0,0.00%,0,0.00%,0,0.00%,0
64,4951.0,298,243,81.54%,243,81.54%,244,81.88%,1,0.34%,0
65,9999.0,5,0,0.00%,0,0.00%,0,0.00%,0,0.00%,0
66,254.0,452,412,91.15%,409,90.49%,416,92.04%,4,0.88%,3
67,9999.0,3,1,33.33%,1,33.33%,1,33.33%,0,0.00%,0
68,8305.0,687,636,92.58%,636,92.58%,638,92.87%,2,0.29%,0
69,9999.0,1,0,0.00%,0,0.00%,0,0.00%,0,0.00%,0
70,53.0,70,60,85.71%,60,85.71%,61,87.14%,1,1.43%,0
71,9999.0,3,0,0.00%,0,0.00%,0,0.00%,0,0.00%,0
72,7101.0,334,266,79.64%,265,79.34%,275,82.34%,9,2.69%,1
73,309.0,300,235,78.33%,227,75.67%,244,81.33%,9,3.00%,8
74,9999.0,9,0,0.00%,0,0.00%,0,0.00%,0,0.00%,0
75,435.0,291,221,75.95%,217,74.57%,224,76.98%,3,1.03%,4
76,9999.0,1,0,0.00%,0,0.00%,0,0.00%,0,0.00%,0
77,448.0,173,143,82.66%,143,82.66%,143,82.66%,0,0.00%,0
78,9999.0,5,1,20.00%,1,20.00%,1,20.00%,0,0.00%,0
79,6928.0,64,47,73.44%,44,68.75%,48,75.00%,1,1.56%,3
80,9999.0,1,0,0.00%,0,0.00%,0,0.00%,0,0.00%,0
81,460.0,311,225,72.35%,223,71.70%,243,78.14%,18,5.79%,2
82,9999.0,3,0,0.00%,0,0.00%,0,0.00%,0,0.00%,0
83,8392.0,33,27,81.82%,27,81.82%,29,87.88%,2,6.06%,0
84,440.0,116,83,71.55%,83,71.55%,88,75.86%,5,4.31%,0
85,9999.0,1,0,0.00%,0,0.00%,0,0.00%,0,0.00%,0
86,470.0,203,188,92.61%,186,91.63%,195,96.06%,7,3.45%,2
87,9999.0,6,0,0.00%,0,0.00%,0,0.00%,0,0.00%,0
88,467.0,139,111,79.86%,111,79.86%,111,79.86%,0,0.00%,0
89,9999.0,4,0,0.00%,0,0.00%,0,0.00%,0,0.00%,0
90,196.0,96,63,65.63%,58,60.42%,63,65.63%,0,0.00%,5
91,9999.0,2,0,0.00%,0,0.00%,0,0.00%,0,0.00%,0
92,477.0,70,30,42.86%,25,35.71%,30,42.86%,0,0.00%,5
93,492.0,344,319,92.73%,319,92.73%,325,94.48%,6,1.74%,0
94,9999.0,2,0,0.00%,0,0.00%,0,0.00%,0,0.00%,0
95,509.0,265,209,78.87%,206,77.74%,217,81.89%,8,3.02%,3
96,523.0,229,191,83.41%,191,83.41%,191,83.41%,0,0.00%,0
97,536.0,252,171,67.86%,156,61.90%,172,68.25%,1,0.40%,15
98,9999.0,4,0,0.00%,0,0.00%,0,0.00%,0,0.00%,0
99,107.0,237,156,65.82%,142,59.92%,165,69.62%,9,3.80%,14
100,7821.0,59,36,61.02%,35,59.32%,40,67.80%,4,6.78%,1
101,8129.0,39,31,79.49%,30,76.92%,34,87.18%,3,7.69%,1
102,2320.0,75,48,64.00%,48,64.00%,51,68.00%,3,4.00%,0
103,9999.0,5,0,0.00%,0,0.00%,0,0.00%,0,0.00%,0
104,7640.0,84,47,55.95%,44,52.38%,49,58.33%,2,2.38%,3
105,8342.0,207,134,64.73%,133,64.25%,136,65.70%,2,0.97%,1
106,9999.0,6,0,0.00%,0,0.00%,0,0.00%,0,0.00%,0
107,594.0,142,121,85.21%,109,76.76%,121,85.21%,0,0.00%,12
108,9999.0,1,0,0.00%,0,0.00%,0,0.00%,0,0.00%,0
109,7923.0,49,30,61.22%,25,51.02%,32,65.31%,2,4.08%,5
110,9999.0,1,1,100.00%,0,0.00%,1,100.00%,0,0.00%,1
111,4807.0,137,47,34.31%,43,31.39%,53,38.69%,6,4.38%,4
112,7859.0,143,122,85.31%,115,80.42%,122,85.31%,0,0.00%,7
113,8086.0,69,27,39.13%,27,39.13%,27,39.13%,0,0.00%,0
114,6555.0,174,114,65.52%,112,64.37%,120,68.97%,6,3.45%,2
115,9999.0,4,0,0.00%,0,0.00%,0,0.00%,0,0.00%,0
116,640.0,180,144,80.00%,142,78.89%,148,82.22%,4,2.22%,2
117,9999.0,2,0,0.00%,0,0.00%,0,0.00%,0,0.00%,0
118,649.0,103,65,63.11%,63,61.17%,68,66.02%,3,2.91%,2
119,9999.0,1,0,0.00%,0,0.00%,0,0.00%,0,0.00%,0
120,6707.0,150,120,80.00%,116,77.33%,122,81.33%,2,1.33%,4
121,9999.0,3,0,0.00%,0,0.00%,1,33.33%,1,33.33%,0
122,8044.0,149,101,67.79%,97,65.10%,105,70.47%,4,2.68%,4
123,6563.0,98,69,70.41%,63,64.29%,73,74.49%,4,4.08%,6
124,9999.0,2,0,0.00%,0,0.00%,0,0.00%,0,0.00%,0
125,7650.0,"1,173",548,46.72%,465,39.64%,566,48.25%,18,1.53%,83
126,9999.0,2,0,0.00%,0,0.00%,0,0.00%,0,0.00%,0
127,675.0,154,113,73.38%,113,73.38%,118,76.62%,5,3.25%,0
128,695.0,98,62,63.27%,55,56.12%,64,65.31%,2,2.04%,7
129,700.0,123,69,56.10%,63,51.22%,70,56.91%,1,0.81%,6
130,8000.0,52,32,61.54%,32,61.54%,40,76.92%,8,15.38%,0
131,9999.0,2,0,0.00%,0,0.00%,0,0.00%,0,0.00%,0
132,714.0,70,50,71.43%,50,71.43%,50,71.43%,0,0.00%,0
133,719.0,52,33,63.46%,31,59.62%,34,65.38%,1,1.92%,2
134,726.0,137,67,48.91%,65,47.45%,73,53.28%,6,4.38%,2
135,732.0,115,68,59.13%,59,51.30%,73,63.48%,5,4.35%,9
136,9999.0,1,0,0.00%,0,0.00%,0,0.00%,0,0.00%,0
137,7897.0,99,43,43.43%,43,43.43%,47,47.47%,4,4.04%,0
138,8436.0,54,31,57.41%,30,55.56%,32,59.26%,1,1.85%,1
139,8154.0,15,9,60.00%,9,60.00%,9,60.00%,0,0.00%,0
140,753.0,65,23,35.38%,22,33.85%,28,43.08%,5,7.69%,1
141,8155.0,89,0,0.00%,0,0.00%,0,0.00%,0,0.00%,0
142,820.0,61,41,67.21%,38,62.30%,43,70.49%,2,3.28%,3
143,6306.0,485,361,74.43%,359,74.02%,366,75.46%,5,1.03%,2
144,9999.0,23,4,17.39%,3,13.04%,4,17.39%,0,0.00%,1
145,6308.0,115,79,68.70%,74,64.35%,80,69.57%,1,0.87%,5
146,777.0,196,139,70.92%,133,67.86%,141,71.94%,2,1.02%,6
147,9999.0,2,0,0.00%,0,0.00%,0,0.00%,0,0.00%,0
148,4810.0,283,212,74.91%,208,73.50%,213,75.27%,1,0.35%,4
149,9999.0,5,0,0.00%,0,0.00%,0,0.00%,0,0.00%,0
150,787.0,2,0,0.00%,0,0.00%,0,0.00%,0,0.00%,0
151,788.0,288,211,73.26%,209,72.57%,215,74.65%,4,1.39%,2
152,9999.0,4,0,0.00%,0,0.00%,0,0.00%,0,0.00%,0
153,5023.0,197,145,73.60%,144,73.10%,149,75.63%,4,2.03%,1
154,9999.0,4,0,0.00%,0,0.00%,0,0.00%,0,0.00%,0
155,802.0,326,228,69.94%,228,69.94%,234,71.78%,6,1.84%,0
156,808.0,164,118,71.95%,105,64.02%,121,73.78%,3,1.83%,13
157,9999.0,3,0,0.00%,0,0.00%,0,0.00%,0,0.00%,0
158,816.0,108,77,71.30%,77,71.30%,79,73.15%,2,1.85%,0
159,6610.0,277,209,75.45%,204,73.65%,210,75.81%,1,0.36%,5
160,9999.0,1,0,0.00%,0,0.00%,0,0.00%,0,0.00%,0
161,6318.0,134,98,73.13%,98,73.13%,99,73.88%,1,0.75%,0
162,9999.0,7,0,0.00%,0,0.00%,0,0.00%,0,0.00%,0
163,8116.0,887,425,47.91%,406,45.77%,448,50.51%,23,2.59%,19
164,9999.0,11,0,0.00%,0,0.00%,0,0.00%,0,0.00%,0
165,864.0,137,115,83.94%,115,83.94%,115,83.94%,0,0.00%,0
166,9999.0,4,0,0.00%,0,0.00%,0,0.00%,0,0.00%,0
167,4670.0,107,62,57.94%,62,57.94%,68,63.55%,6,5.61%,0
168,9999.0,2,0,0.00%,0,0.00%,0,0.00%,0,0.00%,0
169,873.0,267,197,73.78%,178,66.67%,198,74.16%,1,0.37%,19
170,9999.0,20,3,15.00%,2,10.00%,3,15.00%,0,0.00%,1
171,6980.0,452,288,63.72%,288,63.72%,296,65.49%,8,1.77%,0
172,9999.0,1,0,0.00%,0,0.00%,0,0.00%,0,0.00%,0
173,887.0,145,128,88.28%,127,87.59%,128,88.28%,0,0.00%,1
174,9999.0,2,0,0.00%,0,0.00%,0,0.00%,0,0.00%,0
175,7720.0,16,4,25.00%,4,25.00%,5,31.25%,1,6.25%,0
176,913.0,492,284,57.72%,266,54.07%,303,61.59%,19,3.86%,18
177,7425.0,4,1,25.00%,0,0.00%,1,25.00%,0,0.00%,1
178,9999.0,2,0,0.00%,0,0.00%,0,0.00%,0,0.00%,0
179,917.0,93,62,66.67%,62,66.67%,62,66.67%,0,0.00%,0
180,921.0,80,35,43.75%,23,28.75%,39,48.75%,4,5.00%,12
181,5207.0,270,175,64.81%,174,64.44%,186,68.89%,11,4.07%,1
182,9999.0,9,0,0.00%,0,0.00%,0,0.00%,0,0.00%,0
183,941.0,131,81,61.83%,74,56.49%,89,67.94%,8,6.11%,7
184,9999.0,2,0,0.00%,0,0.00%,0,0.00%,0,0.00%,0
185,949.0,134,73,54.48%,67,50.00%,77,57.46%,4,2.99%,6
186,951.0,34,18,52.94%,17,50.00%,19,55.88%,1,2.94%,1
187,958.0,140,77,55.00%,76,54.29%,81,57.86%,4,2.86%,1
188,988.0,56,21,37.50%,19,33.93%,21,37.50%,0,0.00%,2
189,964.0,63,30,47.62%,28,44.44%,32,50.79%,2,3.17%,2
190,965.0,75,51,68.00%,51,68.00%,56,74.67%,5,6.67%,0
191,5208.0,133,70,52.63%,68,51.13%,80,60.15%,10,7.52%,2
192,1000.0,97,52,53.61%,52,53.61%,54,55.67%,2,2.06%,0
193,1005.0,83,37,44.58%,37,44.58%,40,48.19%,3,3.61%,0
194,7726.0,30,12,40.00%,12,40.00%,15,50.00%,3,10.00%,0
195,5116.0,462,351,75.97%,349,75.54%,362,78.35%,11,2.38%,2
196,9999.0,10,0,0.00%,0,0.00%,0,0.00%,0,0.00%,0
197,1014.0,59,39,66.10%,39,66.10%,42,71.19%,3,5.08%,0
198,9999.0,12,3,25.00%,3,25.00%,3,25.00%,0,0.00%,0
199,1029.0,348,86,24.71%,86,24.71%,92,26.44%,6,1.72%,0
200,9999.0,19,0,0.00%,0,0.00%,0,0.00%,0,0.00%,0
201,1030.0,337,215,63.80%,186,55.19%,216,64.09%,1,0.30%,29
202,1040.0,439,349,79.50%,349,79.50%,366,83.37%,17,3.87%,0
203,9999.0,7,0,0.00%,0,0.00%,0,0.00%,0,0.00%,0
204,1043.0,472,400,84.75%,399,84.53%,402,85.17%,2,0.42%,1
205,5133.0,506,477,94.27%,477,94.27%,477,94.27%,0,0.00%,0
206,7790.0,595,533,89.58%,533,89.58%,534,89.75%,1,0.17%,0
207,9999.0,17,0,0.00%,0,0.00%,0,0.00%,0,0.00%,0
208,5096.0,435,401,92.18%,399,91.72%,403,92.64%,2,0.46%,2
209,7749.0,500,427,85.40%,424,84.80%,433,86.60%,6,1.20%,3
210,9999.0,3,0,0.00%,0,0.00%,0,0.00%,0,0.00%,0
211,7568.0,71,53,74.65%,53,74.65%,57,80.28%,4,5.63%,0
212,8381.0,59,40,67.80%,40,67.80%,41,69.49%,1,1.69%,0
213,6455.0,613,491,80.10%,491,80.10%,517,84.34%,26,4.24%,0
214,9999.0,4,3,75.00%,3,75.00%,3,75.00%,0,0.00%,0
215,1084.0,136,126,92.65%,126,92.65%,127,93.38%,1,0.74%,0
216,1094.0,150,127,84.67%,127,84.67%,127,84.67%,0,0.00%,0
217,9999.0,4,0,0.00%,0,0.00%,0,0.00%,0,0.00%,0
218,1100.0,589,485,82.34%,483,82.00%,487,82.68%,2,0.34%,2
219,9999.0,16,0,0.00%,0,0.00%,0,0.00%,0,0.00%,0
220,4682.0,753,607,80.61%,606,80.48%,616,81.81%,9,1.20%,1
221,9999.0,13,0,0.00%,0,0.00%,0,0.00%,0,0.00%,0
222,1128.0,391,303,77.49%,302,77.24%,306,78.26%,3,0.77%,1
223,9999.0,5,0,0.00%,0,0.00%,0,0.00%,0,0.00%,0
224,8344.0,479,360,75.16%,347,72.44%,396,82.67%,36,7.52%,13
225,9999.0,17,5,29.41%,5,29.41%,5,29.41%,0,0.00%,0
226,1154.0,118,68,57.63%,61,51.69%,70,59.32%,2,1.69%,7
227,9999.0,8,1,12.50%,0,0.00%,1,12.50%,0,0.00%,1
228,1159.0,234,199,85.04%,197,84.19%,207,88.46%,8,3.42%,2
229,9999.0,1,0,0.00%,0,0.00%,0,0.00%,0,0.00%,0
230,1164.0,100,67,67.00%,64,64.00%,67,67.00%,0,0.00%,3
231,9999.0,1,0,0.00%,0,0.00%,0,0.00%,0,0.00%,0
232,1172.0,154,103,66.88%,103,66.88%,110,71.43%,7,4.55%,0
233,9999.0,1,0,0.00%,0,0.00%,0,0.00%,0,0.00%,0
234,1177.0,187,131,70.05%,130,69.52%,135,72.19%,4,2.14%,1
235,9999.0,1,0,0.00%,0,0.00%,0,0.00%,0,0.00%,0
236,8318.0,588,496,84.35%,495,84.18%,526,89.46%,30,5.10%,1
237,9999.0,1,1,100.00%,1,100.00%,1,100.00%,0,0.00%,0
238,5135.0,35,23,65.71%,20,57.14%,23,65.71%,0,0.00%,3
239,9999.0,1,0,0.00%,0,0.00%,0,0.00%,0,0.00%,0
240,5212.0,112,78,69.64%,73,65.18%,81,72.32%,3,2.68%,5
241,1208.0,127,98,77.17%,94,74.02%,102,80.31%,4,3.15%,4
242,9999.0,2,0,0.00%,0,0.00%,0,0.00%,0,0.00%,0
243,5136.0,75,39,52.00%,39,52.00%,41,54.67%,2,2.67%,0
244,9999.0,2,0,0.00%,0,0.00%,0,0.00%,0,0.00%,0
245,1225.0,44,27,61.36%,27,61.36%,28,63.64%,1,2.27%,0
246,9999.0,2,0,0.00%,0,0.00%,0,0.00%,0,0.00%,0
247,8382.0,139,90,64.75%,86,61.87%,91,65.47%,1,0.72%,4
248,1251.0,156,77,49.36%,64,41.03%,77,49.36%,0,0.00%,13
249,8314.0,14,4,28.57%,3,21.43%,4,28.57%,0,0.00%,1
250,9999.0,10,3,30.00%,3,30.00%,3,30.00%,0,0.00%,0
251,6201.0,69,43,62.32%,40,57.97%,43,62.32%,0,0.00%,3
252,1213.0,131,96,73.28%,96,73.28%,103,78.63%,7,5.34%,0
253,9999.0,4,0,0.00%,0,0.00%,0,0.00%,0,0.00%,0
254,1270.0,69,42,60.87%,34,49.28%,43,62.32%,1,1.45%,8
255,7941.0,114,76,66.67%,71,62.28%,76,66.67%,0,0.00%,5
256,9999.0,1,0,0.00%,0,0.00%,0,0.00%,0,0.00%,0
257,8379.0,107,92,85.98%,86,80.37%,92,85.98%,0,0.00%,6
258,1299.0,44,19,43.18%,19,43.18%,19,43.18%,0,0.00%,0
259,4870.0,79,37,46.84%,37,46.84%,37,46.84%,0,0.00%,0
260,1307.0,135,104,77.04%,103,76.30%,111,82.22%,7,5.19%,1
261,9999.0,7,2,28.57%,2,28.57%,2,28.57%,0,0.00%,0
262,1315.0,155,98,63.23%,96,61.94%,110,70.97%,12,7.74%,2
263,4734.0,107,83,77.57%,80,74.77%,84,78.50%,1,0.93%,3
264,9999.0,4,1,25.00%,1,25.00%,1,25.00%,0,0.00%,0
265,8348.0,96,65,67.71%,61,63.54%,67,69.79%,2,2.08%,4
266,1327.0,46,34,73.91%,34,73.91%,35,76.09%,1,2.17%,0
267,9999.0,2,0,0.00%,0,0.00%,0,0.00%,0,0.00%,0
268,1335.0,131,66,50.38%,64,48.85%,69,52.67%,3,2.29%,2
269,1343.0,204,132,64.71%,123,60.29%,137,67.16%,5,2.45%,9
270,6231.0,110,80,72.73%,71,64.55%,80,72.73%,0,0.00%,9
271,1364.0,566,440,77.74%,436,77.03%,448,79.15%,8,1.41%,4
272,7691.0,216,115,53.24%,113,52.31%,131,60.65%,16,7.41%,2
273,7721.0,74,59,79.73%,59,79.73%,60,81.08%,1,1.35%,0
274,9999.0,3,0,0.00%,0,0.00%,0,0.00%,0,0.00%,0
275,7819.0,345,223,64.64%,223,64.64%,246,71.30%,23,6.67%,0
276,1367.0,424,368,86.79%,355,83.73%,372,87.74%,4,0.94%,13
277,9999.0,11,1,9.09%,1,9.09%,1,9.09%,0,0.00%,0
278,5012.0,435,310,71.26%,288,66.21%,336,77.24%,26,5.98%,22
279,8415.0,25,2,8.00%,2,8.00%,2,8.00%,0,0.00%,0
280,9999.0,17,1,5.88%,1,5.88%,1,5.88%,0,0.00%,0
281,1387.0,377,319,84.62%,311,82.49%,323,85.68%,4,1.06%,8
282,7759.0,426,386,90.61%,384,90.14%,390,91.55%,4,0.94%,2
283,8174.0,186,186,100.00%,186,100.00%,186,100.00%,0,0.00%,0
284,9999.0,8,0,0.00%,0,0.00%,0,0.00%,0,0.00%,0
285,7628.0,87,70,80.46%,70,80.46%,76,87.36%,6,6.90%,0
286,9999.0,2,0,0.00%,0,0.00%,0,0.00%,0,0.00%,0
287,7636.0,63,57,90.48%,56,88.89%,57,90.48%,0,0.00%,1
288,9999.0,1,1,100.00%,1,100.00%,1,100.00%,0,0.00%,0
289,1424.0,303,273,90.10%,273,90.10%,277,91.42%,4,1.32%,0
290,9999.0,26,0,0.00%,0,0.00%,0,0.00%,0,0.00%,0
291,6482.0,299,227,75.92%,225,75.25%,240,80.27%,13,4.35%,2
292,9999.0,3,0,0.00%,0,0.00%,0,0.00%,0,0.00%,0
293,1414.0,167,118,70.66%,118,70.66%,120,71.86%,2,1.20%,0
294,9999.0,14,0,0.00%,0,0.00%,0,0.00%,0,0.00%,0
295,1406.0,394,334,84.77%,329,83.50%,336,85.28%,2,0.51%,5
296,9999.0,23,5,21.74%,5,21.74%,5,21.74%,0,0.00%,0
297,1420.0,313,201,64.22%,200,63.90%,211,67.41%,10,3.19%,1
298,1426.0,252,216,85.71%,216,85.71%,223,88.49%,7,2.78%,0
299,9999.0,7,0,0.00%,0,0.00%,0,0.00%,0,0.00%,0
300,1423.0,514,502,97.67%,502,97.67%,503,97.86%,1,0.19%,0
301,9999.0,16,7,43.75%,7,43.75%,8,50.00%,1,6.25%,0
302,1443.0,356,344,96.63%,344,96.63%,345,96.91%,1,0.28%,0
303,9999.0,2,1,50.00%,1,50.00%,1,50.00%,0,0.00%,0
304,1453.0,304,276,90.79%,275,90.46%,278,91.45%,2,0.66%,1
305,6734.0,310,286,92.26%,283,91.29%,291,93.87%,5,1.61%,3
306,7894.0,311,290,93.25%,285,91.64%,292,93.89%,2,0.64%,5
307,9999.0,28,7,25.00%,6,21.43%,8,28.57%,1,3.57%,1
308,7824.0,100,37,37.00%,32,32.00%,53,53.00%,16,16.00%,5
309,4664.0,58,35,60.34%,34,58.62%,36,62.07%,1,1.72%,1
310,9999.0,9,0,0.00%,0,0.00%,0,0.00%,0,0.00%,0
311,1475.0,68,47,69.12%,45,66.18%,47,69.12%,0,0.00%,2
312,9999.0,3,1,33.33%,1,33.33%,1,33.33%,0,0.00%,0
313,1480.0,56,41,73.21%,40,71.43%,43,76.79%,2,3.57%,1
314,1486.0,74,35,47.30%,33,44.59%,40,54.05%,5,6.76%,2
315,1489.0,47,28,59.57%,27,57.45%,31,65.96%,3,6.38%,1
316,1495.0,91,0,0.00%,0,0.00%,0,0.00%,0,0.00%,0
317,9999.0,4,0,0.00%,0,0.00%,0,0.00%,0,0.00%,0
318,1501.0,31,17,54.84%,17,54.84%,18,58.06%,1,3.23%,0
319,6156.0,220,110,50.00%,107,48.64%,113,51.36%,3,1.36%,3
320,9999.0,2,0,0.00%,0,0.00%,0,0.00%,0,0.00%,0
321,6236.0,144,90,62.50%,76,52.78%,90,62.50%,0,0.00%,14
322,9999.0,2,0,0.00%,0,0.00%,0,0.00%,0,0.00%,0
323,1529.0,68,38,55.88%,36,52.94%,39,57.35%,1,1.47%,2
324,9999.0,1,0,0.00%,0,0.00%,0,0.00%,0,0.00%,0
325,5219.0,70,46,65.71%,44,62.86%,48,68.57%,2,2.86%,2
326,9999.0,2,0,0.00%,0,0.00%,0,0.00%,0,0.00%,0
327,8316.0,18,7,38.89%,7,38.89%,7,38.89%,0,0.00%,0
328,1550.0,69,35,50.72%,24,34.78%,35,50.72%,0,0.00%,11
329,9999.0,1,0,0.00%,0,0.00%,0,0.00%,0,0.00%,0
330,1560.0,112,60,53.57%,52,46.43%,62,55.36%,2,1.79%,8
331,9999.0,1,0,0.00%,0,0.00%,0,0.00%,0,0.00%,0
332,1566.0,101,49,48.51%,36,35.64%,51,50.50%,2,1.98%,13
333,7635.0,29,18,62.07%,18,62.07%,18,62.07%,0,0.00%,0
334,6241.0,35,15,42.86%,10,28.57%,15,42.86%,0,0.00%,5
335,7589.0,280,147,52.50%,141,50.36%,148,52.86%,1,0.36%,6
336,8434.0,38,19,50.00%,19,50.00%,21,55.26%,2,5.26%,0
337,1605.0,166,112,67.47%,111,66.87%,112,67.47%,0,0.00%,1
338,9999.0,3,0,0.00%,0,0.00%,0,0.00%,0,0.00%,0
339,1612.0,74,55,74.32%,55,74.32%,55,74.32%,0,0.00%,0
340,9999.0,5,0,0.00%,0,0.00%,0,0.00%,0,0.00%,0
341,1619.0,131,108,82.44%,105,80.15%,108,82.44%,0,0.00%,3
342,5178.0,134,35,26.12%,35,26.12%,43,32.09%,8,5.97%,0
343,1623.0,49,36,73.47%,36,73.47%,36,73.47%,0,0.00%,0
344,1627.0,105,84,80.00%,84,80.00%,88,83.81%,4,3.81%,0
345,7567.0,16,6,37.50%,5,31.25%,8,50.00%,2,12.50%,1
346,8224.0,167,72,43.11%,71,42.51%,81,48.50%,9,5.39%,1
347,9999.0,1,0,0.00%,0,0.00%,0,0.00%,0,0.00%,0
348,1632.0,83,51,61.45%,46,55.42%,51,61.45%,0,0.00%,5
349,1654.0,189,98,51.85%,94,49.74%,104,55.03%,6,3.17%,4
350,9999.0,1,0,0.00%,0,0.00%,0,0.00%,0,0.00%,0
351,1629.0,55,33,60.00%,33,60.00%,39,70.91%,6,10.91%,0
352,6136.0,81,43,53.09%,41,50.62%,51,62.96%,8,9.88%,2
353,6942.0,89,46,51.69%,41,46.07%,48,53.93%,2,2.25%,5
354,9999.0,3,0,0.00%,0,0.00%,0,0.00%,0,0.00%,0
355,1677.0,194,118,60.82%,114,58.76%,118,60.82%,0,0.00%,4
356,9999.0,2,0,0.00%,0,0.00%,0,0.00%,0,0.00%,0
357,1682.0,82,76,92.68%,76,92.68%,76,92.68%,0,0.00%,0
358,1694.0,347,250,72.05%,242,69.74%,251,72.33%,1,0.29%,8
359,9999.0,4,0,0.00%,0,0.00%,0,0.00%,0,0.00%,0
360,1701.0,638,522,81.82%,518,81.19%,526,82.45%,4,0.63%,4
361,9999.0,4,1,25.00%,1,25.00%,1,25.00%,0,0.00%,0
362,1707.0,189,133,70.37%,133,70.37%,136,71.96%,3,1.59%,0
363,5098.0,283,204,72.08%,200,70.67%,207,73.14%,3,1.06%,4
364,9999.0,5,0,0.00%,0,0.00%,0,0.00%,0,0.00%,0
365,5221.0,248,159,64.11%,155,62.50%,166,66.94%,7,2.82%,4
366,6328.0,169,113,66.86%,113,66.86%,115,68.05%,2,1.18%,0
367,7774.0,840,12,1.43%,12,1.43%,13,1.55%,1,0.12%,0
368,1745.0,403,325,80.65%,323,80.15%,328,81.39%,3,0.74%,2
369,1746.0,325,139,42.77%,139,42.77%,139,42.77%,0,0.00%,0
370,9999.0,6,0,0.00%,0,0.00%,0,0.00%,0,0.00%,0
371,5278.0,264,123,46.59%,112,42.42%,130,49.24%,7,2.65%,11
372,4801.0,273,231,84.62%,231,84.62%,232,84.98%,1,0.37%,0
373,9999.0,2,0,0.00%,0,0.00%,0,0.00%,0,0.00%,0
374,6330.0,62,34,54.84%,32,51.61%,34,54.84%,0,0.00%,2
375,6333.0,205,111,54.15%,109,53.17%,118,57.56%,7,3.41%,2
376,7902.0,93,93,100.00%,93,100.00%,93,100.00%,0,0.00%,0
377,8376.0,12,9,75.00%,9,75.00%,9,75.00%,0,0.00%,0
378,9999.0,35,8,22.86%,8,22.86%,8,22.86%,0,0.00%,0
379,1776.0,264,193,73.11%,193,73.11%,196,74.24%,3,1.14%,0
380,7844.0,1,1,100.00%,1,100.00%,1,100.00%,0,0.00%,0
381,9999.0,4,0,0.00%,0,0.00%,0,0.00%,0,0.00%,0
382,1790.0,129,69,53.49%,64,49.61%,74,57.36%,5,3.88%,5
383,1794.0,71,42,59.15%,42,59.15%,44,61.97%,2,2.82%,0
384,8278.0,49,35,71.43%,35,71.43%,38,77.55%,3,6.12%,0
385,8366.0,242,0,0.00%,0,0.00%,0,0.00%,0,0.00%,0
386,1801.0,73,43,58.90%,43,58.90%,47,64.38%,4,5.48%,0
387,9999.0,3,2,66.67%,2,66.67%,2,66.67%,0,0.00%,0
388,1806.0,190,162,85.26%,162,85.26%,163,85.79%,1,0.53%,0
389,9999.0,19,8,42.11%,8,42.11%,8,42.11%,0,0.00%,0
390,6340.0,92,67,72.83%,61,66.30%,68,73.91%,1,1.09%,6
391,6492.0,174,97,55.75%,97,55.75%,99,56.90%,2,1.15%,0
392,8303.0,85,71,83.53%,65,76.47%,73,85.88%,2,2.35%,6
393,9999.0,6,1,16.67%,1,16.67%,1,16.67%,0,0.00%,0
394,1849.0,220,148,67.27%,144,65.45%,158,71.82%,10,4.55%,4
395,9999.0,6,0,0.00%,0,0.00%,0,0.00%,0,0.00%,0
396,1869.0,422,378,89.57%,377,89.34%,383,90.76%,5,1.18%,1
397,9999.0,2,0,0.00%,0,0.00%,0,0.00%,0,0.00%,0
398,1879.0,437,383,87.64%,383,87.64%,395,90.39%,12,2.75%,0
399,9999.0,3,0,0.00%,0,0.00%,0,0.00%,0,0.00%,0
400,1885.0,289,188,65.05%,180,62.28%,196,67.82%,8,2.77%,8
401,9999.0,2,0,0.00%,0,0.00%,0,0.00%,0,0.00%,0
402,1902.0,272,232,85.29%,231,84.93%,233,85.66%,1,0.37%,1
403,9999.0,13,1,7.69%,1,7.69%,1,7.69%,0,0.00%,0
404,8258.0,45,40,88.89%,37,82.22%,43,95.56%,3,6.67%,3
405,1915.0,255,216,84.71%,215,84.31%,216,84.71%,0,0.00%,1
406,9999.0,4,0,0.00%,0,0.00%,0,0.00%,0,0.00%,0
407,1921.0,285,262,91.93%,262,91.93%,265,92.98%,3,1.05%,0
408,9999.0,2,0,0.00%,0,0.00%,0,0.00%,0,0.00%,0
409,1934.0,436,343,78.67%,319,73.17%,346,79.36%,3,0.69%,24
410,9999.0,8,1,12.50%,1,12.50%,1,12.50%,0,0.00%,0
411,1942.0,330,307,93.03%,306,92.73%,311,94.24%,4,1.21%,1
412,6516.0,292,0,0.00%,0,0.00%,1,0.34%,1,0.34%,0
413,9999.0,4,0,0.00%,0,0.00%,0,0.00%,0,0.00%,0
414,1950.0,285,250,87.72%,245,85.96%,253,88.77%,3,1.05%,5
415,9999.0,3,1,33.33%,1,33.33%,1,33.33%,0,0.00%,0
416,1972.0,848,678,79.95%,678,79.95%,685,80.78%,7,0.83%,0
417,9999.0,22,6,27.27%,6,27.27%,6,27.27%,0,0.00%,0
418,5287.0,264,245,92.80%,243,92.05%,248,93.94%,3,1.14%,2
419,8231.0,323,240,74.30%,225,69.66%,240,74.30%,0,0.00%,15
420,9999.0,6,0,0.00%,0,0.00%,0,0.00%,0,0.00%,0
421,6218.0,42,33,78.57%,27,64.29%,33,78.57%,0,0.00%,6
422,1989.0,73,44,60.27%,42,57.53%,44,60.27%,0,0.00%,2
423,5169.0,147,96,65.31%,93,63.27%,100,68.03%,4,2.72%,3
424,9999.0,1,0,0.00%,0,0.00%,0,0.00%,0,0.00%,0
425,7770.0,88,65,73.86%,55,62.50%,69,78.41%,4,4.55%,10
426,1998.0,133,48,36.09%,45,33.83%,54,40.60%,6,4.51%,3
427,9999.0,2,0,0.00%,0,0.00%,0,0.00%,0,0.00%,0
428,7515.0,171,167,97.66%,166,97.08%,167,97.66%,0,0.00%,1
429,8417.0,447,165,36.91%,149,33.33%,178,39.82%,13,2.91%,16
430,9999.0,5,0,0.00%,0,0.00%,0,0.00%,0,0.00%,0
431,6737.0,132,112,84.85%,112,84.85%,112,84.85%,0,0.00%,0
432,2037.0,171,104,60.82%,100,58.48%,113,66.08%,9,5.26%,4
433,9999.0,3,0,0.00%,0,0.00%,0,0.00%,0,0.00%,0
434,2040.0,176,124,70.45%,123,69.89%,125,71.02%,1,0.57%,1
435,2043.0,128,59,46.09%,52,40.63%,62,48.44%,3,2.34%,7
436,9999.0,1,0,0.00%,0,0.00%,0,0.00%,0,0.00%,0
437,7948.0,148,93,62.84%,93,62.84%,93,62.84%,0,0.00%,0
438,9999.0,2,0,0.00%,0,0.00%,0,0.00%,0,0.00%,0
439,4817.0,86,38,44.19%,33,38.37%,40,46.51%,2,2.33%,5
440,9999.0,1,0,0.00%,0,0.00%,0,0.00%,0,0.00%,0
441,8071.0,502,322,64.14%,316,62.95%,335,66.73%,13,2.59%,6
442,9999.0,4,0,0.00%,0,0.00%,0,0.00%,0,0.00%,0
443,6145.0,113,67,59.29%,64,56.64%,72,63.72%,5,4.42%,3
444,9999.0,2,0,0.00%,0,0.00%,0,0.00%,0,0.00%,0
445,6745.0,104,54,51.92%,53,50.96%,54,51.92%,0,0.00%,1
446,2075.0,85,48,56.47%,48,56.47%,49,57.65%,1,1.18%,0
447,6148.0,98,49,50.00%,48,48.98%,52,53.06%,3,3.06%,1
448,9999.0,2,0,0.00%,0,0.00%,0,0.00%,0,0.00%,0
449,6001.0,259,111,42.86%,111,42.86%,144,55.60%,33,12.74%,0
450,4818.0,103,69,66.99%,55,53.40%,70,67.96%,1,0.97%,14
451,5228.0,267,168,62.92%,157,58.80%,170,63.67%,2,0.75%,11
452,9999.0,1,0,0.00%,0,0.00%,0,0.00%,0,0.00%,0
453,2126.0,85,51,60.00%,45,52.94%,55,64.71%,4,4.71%,6
454,9999.0,2,0,0.00%,0,0.00%,0,0.00%,0,0.00%,0
455,6600.0,224,154,68.75%,146,65.18%,157,70.09%,3,1.34%,8
456,9999.0,1,0,0.00%,0,0.00%,0,0.00%,0,0.00%,0
457,6643.0,86,23,26.74%,14,16.28%,24,27.91%,1,1.16%,9
458,2184.0,163,86,52.76%,86,52.76%,93,57.06%,7,4.29%,0
459,9999.0,4,0,0.00%,0,0.00%,0,0.00%,0,0.00%,0
460,6159.0,22,7,31.82%,7,31.82%,9,40.91%,2,9.09%,0
461,6161.0,20,5,25.00%,4,20.00%,6,30.00%,1,5.00%,1
462,9999.0,9,0,0.00%,0,0.00%,0,0.00%,0,0.00%,0
463,2191.0,490,246,50.20%,242,49.39%,248,50.61%,2,0.41%,4
464,8244.0,172,64,37.21%,64,37.21%,65,37.79%,1,0.58%,0
465,9999.0,9,0,0.00%,0,0.00%,0,0.00%,0,0.00%,0
466,2201.0,38,20,52.63%,20,52.63%,21,55.26%,1,2.63%,0
467,2206.0,232,162,69.83%,158,68.10%,165,71.12%,3,1.29%,4
468,9999.0,2,0,0.00%,0,0.00%,0,0.00%,0,0.00%,0
469,6280.0,167,99,59.28%,99,59.28%,101,60.48%,2,1.20%,0
470,9999.0,1,0,0.00%,0,0.00%,0,0.00%,0,0.00%,0
471,2243.0,301,102,33.89%,102,33.89%,164,54.49%,62,20.60%,0
472,9999.0,11,1,9.09%,1,9.09%,1,9.09%,0,0.00%,0
473,6252.0,61,32,52.46%,31,50.82%,32,52.46%,0,0.00%,1
474,2246.0,31,16,51.61%,15,48.39%,16,51.61%,0,0.00%,1
475,2253.0,50,24,48.00%,24,48.00%,28,56.00%,4,8.00%,0
476,7112.0,63,35,55.56%,31,49.21%,36,57.14%,1,1.59%,4
477,5118.0,121,82,67.77%,75,61.98%,82,67.77%,0,0.00%,7
478,9999.0,4,0,0.00%,0,0.00%,0,0.00%,0,0.00%,0
479,2280.0,54,32,59.26%,29,53.70%,36,66.67%,4,7.41%,3
480,2284.0,39,21,53.85%,21,53.85%,28,71.79%,7,17.95%,0
481,9999.0,3,0,0.00%,0,0.00%,0,0.00%,0,0.00%,0
482,8442.0,51,29,56.86%,28,54.90%,31,60.78%,2,3.92%,1
483,2305.0,138,90,65.22%,76,55.07%,92,66.67%,2,1.45%,14
484,2308.0,53,33,62.26%,33,62.26%,36,67.92%,3,5.66%,0
485,7944.0,98,55,56.12%,51,52.04%,63,64.29%,8,8.16%,4
486,2313.0,92,56,60.87%,55,59.78%,57,61.96%,1,1.09%,1
487,7762.0,24,0,0.00%,0,0.00%,0,0.00%,0,0.00%,0
488,2353.0,36,29,80.56%,29,80.56%,30,83.33%,1,2.78%,0
489,4706.0,69,36,52.17%,36,52.17%,38,55.07%,2,2.90%,0
490,9999.0,3,0,0.00%,0,0.00%,0,0.00%,0,0.00%,0
491,2331.0,65,47,72.31%,45,69.23%,50,76.92%,3,4.62%,2
492,2325.0,192,136,70.83%,128,66.67%,137,71.35%,1,0.52%,8
493,9999.0,2,0,0.00%,0,0.00%,0,0.00%,0,0.00%,0
494,2339.0,98,64,65.31%,62,63.27%,70,71.43%,6,6.12%,2
495,2345.0,59,29,49.15%,27,45.76%,30,50.85%,1,1.69%,2
496,9999.0,2,0,0.00%,0,0.00%,0,0.00%,0,0.00%,0
497,2350.0,58,22,37.93%,21,36.21%,22,37.93%,0,0.00%,1
498,2358.0,81,54,66.67%,46,56.79%,54,66.67%,0,0.00%,8
499,9999.0,7,0,0.00%,0,0.00%,0,0.00%,0,0.00%,0
500,2362.0,63,35,55.56%,30,47.62%,35,55.56%,0,0.00%,5
501,6162.0,116,76,65.52%,71,61.21%,79,68.10%,3,2.59%,5
502,9999.0,1,0,0.00%,0,0.00%,0,0.00%,0,0.00%,0
503,5180.0,75,19,25.33%,19,25.33%,20,26.67%,1,1.33%,0
504,6165.0,137,72,52.55%,72,52.55%,90,65.69%,18,13.14%,0
505,9999.0,3,0,0.00%,0,0.00%,0,0.00%,0,0.00%,0
506,2394.0,72,37,51.39%,37,51.39%,45,62.50%,8,11.11%,0
507,6255.0,126,57,45.24%,48,38.10%,61,48.41%,4,3.17%,9
508,5091.0,242,213,88.02%,210,86.78%,213,88.02%,0,0.00%,3
509,9999.0,3,0,0.00%,0,0.00%,0,0.00%,0,0.00%,0
510,2420.0,94,64,68.09%,64,68.09%,67,71.28%,3,3.19%,0
511,9999.0,2,1,50.00%,1,50.00%,2,100.00%,1,50.00%,0
512,8312.0,111,90,81.08%,90,81.08%,94,84.68%,4,3.60%,0
513,9999.0,2,0,0.00%,0,0.00%,0,0.00%,0,0.00%,0
514,6404.0,113,81,71.68%,80,70.80%,81,71.68%,0,0.00%,1
515,8304.0,110,72,65.45%,72,65.45%,72,65.45%,0,0.00%,0
516,9999.0,5,0,0.00%,0,0.00%,0,0.00%,0,0.00%,0
517,2446.0,242,196,80.99%,196,80.99%,196,80.99%,0,0.00%,0
518,9999.0,3,0,0.00%,0,0.00%,0,0.00%,0,0.00%,0
519,2449.0,68,53,77.94%,53,77.94%,55,80.88%,2,2.94%,0
520,2496.0,103,64,62.14%,64,62.14%,68,66.02%,4,3.88%,0
521,2489.0,206,112,54.37%,110,53.40%,114,55.34%,2,0.97%,2
522,6413.0,406,226,55.67%,225,55.42%,243,59.85%,17,4.19%,1
523,9999.0,31,6,19.35%,6,19.35%,6,19.35%,0,0.00%,0
524,6775.0,184,135,73.37%,122,66.30%,135,73.37%,0,0.00%,13
525,9999.0,1,0,0.00%,0,0.00%,0,0.00%,0,0.00%,0
526,6290.0,255,160,62.75%,156,61.18%,162,63.53%,2,0.78%,4
527,9999.0,3,0,0.00%,0,0.00%,0,0.00%,0,0.00%,0
528,2515.0,85,53,62.35%,37,43.53%,53,62.35%,0,0.00%,16
529,9999.0,6,0,0.00%,0,0.00%,0,0.00%,0,0.00%,0
530,2532.0,312,231,74.04%,230,73.72%,232,74.36%,1,0.32%,1
531,9999.0,20,3,15.00%,3,15.00%,3,15.00%,0,0.00%,0
532,2539.0,221,155,70.14%,141,63.80%,155,70.14%,0,0.00%,14
533,9999.0,10,1,10.00%,1,10.00%,1,10.00%,0,0.00%,0
534,2554.0,239,113,47.28%,110,46.03%,117,48.95%,4,1.67%,3
535,9999.0,1,0,0.00%,0,0.00%,0,0.00%,0,0.00%,0
536,2562.0,282,193,68.44%,181,64.18%,198,70.21%,5,1.77%,12
537,9999.0,1,0,0.00%,0,0.00%,0,0.00%,0,0.00%,0
538,6293.0,276,172,62.32%,160,57.97%,175,63.41%,3,1.09%,12
539,7538.0,35,7,20.00%,6,17.14%,8,22.86%,1,2.86%,1
540,2578.0,553,372,67.27%,372,67.27%,424,76.67%,52,9.40%,0
541,9999.0,4,0,0.00%,0,0.00%,0,0.00%,0,0.00%,0
542,2607.0,248,189,76.21%,182,73.39%,194,78.23%,5,2.02%,7
543,9999.0,5,0,0.00%,0,0.00%,0,0.00%,0,0.00%,0
544,2596.0,595,409,68.74%,372,62.52%,425,71.43%,16,2.69%,37
545,7922.0,117,11,9.40%,11,9.40%,11,9.40%,0,0.00%,0
546,9999.0,8,0,0.00%,0,0.00%,0,0.00%,0,0.00%,0
547,2618.0,217,131,60.37%,131,60.37%,133,61.29%,2,0.92%,0
548,9999.0,6,0,0.00%,0,0.00%,0,0.00%,0,0.00%,0
549,2623.0,392,316,80.61%,300,76.53%,322,82.14%,6,1.53%,16
550,9999.0,7,1,14.29%,1,14.29%,1,14.29%,0,0.00%,0
551,2633.0,409,283,69.19%,265,64.79%,287,70.17%,4,0.98%,18
552,9999.0,13,1,7.69%,1,7.69%,1,7.69%,0,0.00%,0
553,2649.0,112,69,61.61%,61,54.46%,75,66.96%,6,5.36%,8
554,9999.0,6,2,33.33%,2,33.33%,2,33.33%,0,0.00%,0
555,2658.0,270,138,51.11%,133,49.26%,141,52.22%,3,1.11%,5
556,9999.0,1,0,0.00%,0,0.00%,0,0.00%,0,0.00%,0
557,2663.0,342,214,62.57%,210,61.40%,217,63.45%,3,0.88%,4
558,2675.0,119,81,68.07%,80,67.23%,88,73.95%,7,5.88%,1
559,2680.0,76,53,69.74%,53,69.74%,58,76.32%,5,6.58%,0
560,4940.0,125,33,26.40%,33,26.40%,38,30.40%,5,4.00%,0
561,2686.0,82,65,79.27%,61,74.39%,72,87.80%,7,8.54%,4
562,2689.0,91,80,87.91%,79,86.81%,82,90.11%,2,2.20%,1
563,9999.0,1,1,100.00%,1,100.00%,1,100.00%,0,0.00%,0
564,2704.0,166,112,67.47%,106,63.86%,112,67.47%,0,0.00%,6
565,9999.0,23,0,0.00%,0,0.00%,0,0.00%,0,0.00%,0
566,2708.0,78,56,71.79%,51,65.38%,57,73.08%,1,1.28%,5
567,9999.0,2,0,0.00%,0,0.00%,0,0.00%,0,0.00%,0
568,2712.0,43,30,69.77%,29,67.44%,33,76.74%,3,6.98%,1
569,9999.0,1,1,100.00%,1,100.00%,1,100.00%,0,0.00%,0
570,2721.0,89,66,74.16%,66,74.16%,66,74.16%,0,0.00%,0
571,9999.0,1,0,0.00%,0,0.00%,0,0.00%,0,0.00%,0
572,2725.0,109,74,67.89%,74,67.89%,77,70.64%,3,2.75%,0
573,9999.0,2,0,0.00%,0,0.00%,0,0.00%,0,0.00%,0
574,4800.0,366,258,70.49%,238,65.03%,269,73.50%,11,3.01%,20
575,2740.0,161,89,55.28%,89,55.28%,90,55.90%,1,0.62%,0
576,9999.0,1,0,0.00%,0,0.00%,0,0.00%,0,0.00%,0
577,5155.0,254,81,31.89%,76,29.92%,81,31.89%,0,0.00%,5
578,9999.0,12,0,0.00%,0,0.00%,0,0.00%,0,0.00%,0
579,2760.0,153,83,54.25%,77,50.33%,84,54.90%,1,0.65%,6
580,9999.0,4,0,0.00%,0,0.00%,0,0.00%,0,0.00%,0
581,2766.0,262,193,73.66%,193,73.66%,197,75.19%,4,1.53%,0
582,9999.0,1,0,0.00%,0,0.00%,0,0.00%,0,0.00%,0
583,2794.0,572,300,52.45%,296,51.75%,332,58.04%,32,5.59%,4
584,2795.0,406,238,58.62%,229,56.40%,252,62.07%,14,3.45%,9
585,8412.0,89,66,74.16%,66,74.16%,69,77.53%,3,3.37%,0
586,9999.0,122,46,37.70%,45,36.89%,56,45.90%,10,8.20%,1
587,2798.0,103,60,58.25%,57,55.34%,61,59.22%,1,0.97%,3
588,2809.0,667,513,76.91%,507,76.01%,516,77.36%,3,0.45%,6
589,8401.0,41,36,87.80%,36,87.80%,40,97.56%,4,9.76%,0
590,2818.0,128,98,76.56%,93,72.66%,99,77.34%,1,0.78%,5
591,9999.0,7,0,0.00%,0,0.00%,0,0.00%,0,0.00%,0
592,2821.0,190,148,77.89%,146,76.84%,150,78.95%,2,1.05%,2
593,9999.0,4,1,25.00%,1,25.00%,1,25.00%,0,0.00%,0
594,2829.0,772,670,86.79%,670,86.79%,680,88.08%,10,1.30%,0
595,9999.0,2,1,50.00%,1,50.00%,1,50.00%,0,0.00%,0
596,8371.0,32,20,62.50%,19,59.38%,22,68.75%,2,6.25%,1
597,2833.0,130,100,76.92%,100,76.92%,100,76.92%,0,0.00%,0
598,9999.0,1,1,100.00%,1,100.00%,1,100.00%,0,0.00%,0
599,2839.0,261,216,82.76%,216,82.76%,218,83.52%,2,0.77%,0
600,9999.0,4,1,25.00%,1,25.00%,1,25.00%,0,0.00%,0
601,2848.0,348,242,69.54%,242,69.54%,254,72.99%,12,3.45%,0
602,9999.0,2,0,0.00%,0,0.00%,0,0.00%,0,0.00%,0
603,8325.0,75,50,66.67%,48,64.00%,52,69.33%,2,2.67%,2
604,8125.0,41,39,95.12%,39,95.12%,39,95.12%,0,0.00%,0
605,8446.0,214,166,77.57%,165,77.10%,168,78.50%,2,0.93%,1
606,9999.0,8,2,25.00%,2,25.00%,2,25.00%,0,0.00%,0
607,2869.0,203,175,86.21%,175,86.21%,175,86.21%,0,0.00%,0
608,9999.0,5,3,60.00%,3,60.00%,4,80.00%,1,20.00%,0
609,5242.0,170,111,65.29%,111,65.29%,112,65.88%,1,0.59%,0
610,9999.0,10,1,10.00%,1,10.00%,1,10.00%,0,0.00%,0
611,2891.0,139,83,59.71%,81,58.27%,85,61.15%,2,1.44%,2
612,9999.0,7,0,0.00%,0,0.00%,0,0.00%,0,0.00%,0
613,7348.0,729,517,70.92%,492,67.49%,523,71.74%,6,0.82%,25
614,2924.0,131,105,80.15%,105,80.15%,108,82.44%,3,2.29%,0
615,2958.0,60,42,70.00%,42,70.00%,42,70.00%,0,0.00%,0
616,9999.0,2,0,0.00%,0,0.00%,0,0.00%,0,0.00%,0
617,5058.0,236,186,78.81%,184,77.97%,196,83.05%,10,4.24%,2
618,5059.0,102,52,50.98%,50,49.02%,52,50.98%,0,0.00%,2
619,3007.0,208,157,75.48%,152,73.08%,157,75.48%,0,0.00%,5
620,3008.0,144,60,41.67%,59,40.97%,62,43.06%,2,1.39%,1
621,3009.0,133,106,79.70%,102,76.69%,108,81.20%,2,1.50%,4
622,8448.0,15,15,100.00%,15,100.00%,15,100.00%,0,0.00%,0
623,9999.0,25,2,8.00%,2,8.00%,2,8.00%,0,0.00%,0
624,6390.0,175,126,72.00%,125,71.43%,131,74.86%,5,2.86%,1
625,9999.0,9,0,0.00%,0,0.00%,0,0.00%,0,0.00%,0
626,6391.0,299,228,76.25%,222,74.25%,231,77.26%,3,1.00%,6
627,9999.0,6,0,0.00%,0,0.00%,0,0.00%,0,0.00%,0
628,6364.0,116,75,64.66%,75,64.66%,80,68.97%,5,4.31%,0
629,9999.0,1,0,0.00%,0,0.00%,0,0.00%,0,0.00%,0
630,3034.0,151,43,28.48%,40,26.49%,50,33.11%,7,4.64%,3
631,9999.0,1,0,0.00%,0,0.00%,0,0.00%,0,0.00%,0
632,4828.0,127,94,74.02%,94,74.02%,94,74.02%,0,0.00%,0
633,3040.0,66,41,62.12%,36,54.55%,41,62.12%,0,0.00%,5
634,3045.0,125,86,68.80%,86,68.80%,88,70.40%,2,1.60%,0
635,9999.0,4,0,0.00%,0,0.00%,0,0.00%,0,0.00%,0
636,3048.0,65,40,61.54%,40,61.54%,40,61.54%,0,0.00%,0
637,9999.0,1,0,0.00%,0,0.00%,0,0.00%,0,0.00%,0
638,3056.0,88,58,65.91%,58,65.91%,60,68.18%,2,2.27%,0
639,6368.0,311,201,64.63%,201,64.63%,201,64.63%,0,0.00%,0
640,9999.0,2,1,50.00%,1,50.00%,1,50.00%,0,0.00%,0
641,4691.0,178,118,66.29%,111,62.36%,122,68.54%,4,2.25%,7
642,9999.0,6,0,0.00%,0,0.00%,0,0.00%,0,0.00%,0
643,5245.0,81,56,69.14%,56,69.14%,56,69.14%,0,0.00%,0
644,3107.0,52,38,73.08%,37,71.15%,39,75.00%,1,1.92%,1
645,3111.0,39,21,53.85%,21,53.85%,21,53.85%,0,0.00%,0
646,3117.0,71,0,0.00%,0,0.00%,0,0.00%,0,0.00%,0
647,6122.0,31,22,70.97%,12,38.71%,22,70.97%,0,0.00%,10
648,5248.0,43,19,44.19%,16,37.21%,28,65.12%,9,20.93%,3
649,9999.0,1,0,0.00%,0,0.00%,0,0.00%,0,0.00%,0
650,3137.0,116,74,63.79%,72,62.07%,77,66.38%,3,2.59%,2
651,7506.0,27,7,25.93%,3,11.11%,9,33.33%,2,7.41%,4
652,3145.0,155,115,74.19%,109,70.32%,119,76.77%,4,2.58%,6
653,6125.0,29,8,27.59%,8,27.59%,8,27.59%,0,0.00%,0
654,9999.0,2,0,0.00%,0,0.00%,0,0.00%,0,0.00%,0
655,3150.0,144,107,74.31%,101,70.14%,107,74.31%,0,0.00%,6
656,6126.0,41,25,60.98%,22,53.66%,27,65.85%,2,4.88%,3
657,3155.0,72,44,61.11%,44,61.11%,55,76.39%,11,15.28%,0
658,9999.0,1,0,0.00%,0,0.00%,0,0.00%,0,0.00%,0
659,3158.0,76,47,61.84%,41,53.95%,50,65.79%,3,3.95%,6
660,3165.0,81,47,58.02%,47,58.02%,50,61.73%,3,3.70%,0
661,8093.0,125,80,64.00%,80,64.00%,82,65.60%,2,1.60%,0
662,3124.0,93,71,76.34%,67,72.04%,71,76.34%,0,0.00%,4
663,9999.0,1,0,0.00%,0,0.00%,0,0.00%,0,0.00%,0
664,6129.0,67,47,70.15%,47,70.15%,47,70.15%,0,0.00%,0
665,8187.0,397,172,43.32%,149,37.53%,186,46.85%,14,3.53%,23
666,7866.0,14,13,92.86%,13,92.86%,13,92.86%,0,0.00%,0
667,6935.0,344,247,71.80%,238,69.19%,254,73.84%,7,2.03%,9
668,7641.0,238,158,66.39%,158,66.39%,168,70.59%,10,4.20%,0
669,9999.0,1,0,0.00%,0,0.00%,0,0.00%,0,0.00%,0
670,3210.0,374,297,79.41%,290,77.54%,309,82.62%,12,3.21%,7
671,3216.0,361,216,59.83%,212,58.73%,219,60.66%,3,0.83%,4
672,7738.0,414,260,62.80%,260,62.80%,277,66.91%,17,4.11%,0
673,9999.0,4,0,0.00%,0,0.00%,0,0.00%,0,0.00%,0
674,3224.0,420,199,47.38%,198,47.14%,199,47.38%,0,0.00%,1
675,7687.0,193,103,53.37%,95,49.22%,114,59.07%,11,5.70%,8
676,3241.0,567,464,81.83%,462,81.48%,465,82.01%,1,0.18%,2
677,9999.0,4,0,0.00%,0,0.00%,0,0.00%,0,0.00%,0
678,3260.0,310,254,81.94%,253,81.61%,257,82.90%,3,0.97%,1
679,9999.0,13,0,0.00%,0,0.00%,0,0.00%,0,0.00%,0
680,3333.0,364,317,87.09%,316,86.81%,318,87.36%,1,0.27%,1
681,9999.0,8,3,37.50%,1,12.50%,3,37.50%,0,0.00%,2
682,3272.0,405,339,83.70%,338,83.46%,341,84.20%,2,0.49%,1
683,9999.0,6,2,33.33%,2,33.33%,2,33.33%,0,0.00%,0
684,8049.0,54,49,90.74%,49,90.74%,50,92.59%,1,1.85%,0
685,3295.0,371,337,90.84%,337,90.84%,339,91.37%,2,0.54%,0
686,3296.0,321,312,97.20%,312,97.20%,313,97.51%,1,0.31%,0
687,9999.0,7,0,0.00%,0,0.00%,0,0.00%,0,0.00%,0
688,4960.0,183,164,89.62%,164,89.62%,169,92.35%,5,2.73%,0
689,9999.0,1,1,100.00%,1,100.00%,1,100.00%,0,0.00%,0
690,3305.0,385,361,93.77%,361,93.77%,361,93.77%,0,0.00%,0
691,6729.0,324,253,78.09%,239,73.77%,253,78.09%,0,0.00%,14
692,6998.0,76,46,60.53%,37,48.68%,46,60.53%,0,0.00%,9
693,9999.0,12,1,8.33%,1,8.33%,1,8.33%,0,0.00%,0
694,5345.0,"1,063",902,84.85%,902,84.85%,909,85.51%,7,0.66%,0
695,9999.0,1,0,0.00%,0,0.00%,0,0.00%,0,0.00%,0
696,3328.0,462,367,79.44%,361,78.14%,370,80.09%,3,0.65%,6
697,3338.0,229,171,74.67%,164,71.62%,171,74.67%,0,0.00%,7
698,9999.0,3,0,0.00%,0,0.00%,0,0.00%,0,0.00%,0
699,3348.0,166,79,47.59%,79,47.59%,89,53.61%,10,6.02%,0
700,9999.0,2,0,0.00%,0,0.00%,0,0.00%,0,0.00%,0
701,3354.0,550,447,81.27%,447,81.27%,447,81.27%,0,0.00%,0
702,9999.0,28,5,17.86%,5,17.86%,5,17.86%,0,0.00%,0
703,3376.0,187,159,85.03%,159,85.03%,163,87.17%,4,2.14%,0
704,9999.0,1,0,0.00%,0,0.00%,0,0.00%,0,0.00%,0
705,3367.0,585,525,89.74%,521,89.06%,533,91.11%,8,1.37%,4
706,9999.0,20,2,10.00%,2,10.00%,2,10.00%,0,0.00%,0
707,5078.0,358,337,94.13%,337,94.13%,337,94.13%,0,0.00%,0
708,9999.0,2,0,0.00%,0,0.00%,0,0.00%,0,0.00%,0
709,3395.0,270,170,62.96%,169,62.59%,171,63.33%,1,0.37%,1
710,9999.0,23,3,13.04%,3,13.04%,3,13.04%,0,0.00%,0
711,3401.0,228,198,86.84%,198,86.84%,200,87.72%,2,0.88%,0
712,9999.0,4,1,25.00%,1,25.00%,1,25.00%,0,0.00%,0
713,5081.0,200,143,71.50%,138,69.00%,145,72.50%,2,1.00%,5
714,3247.0,302,282,93.38%,282,93.38%,283,93.71%,1,0.33%,0
715,9999.0,10,6,60.00%,6,60.00%,6,60.00%,0,0.00%,0
716,7858.0,677,311,45.94%,302,44.61%,379,55.98%,68,10.04%,9
717,9999.0,2,0,0.00%,0,0.00%,0,0.00%,0,0.00%,0
718,3425.0,166,129,77.71%,125,75.30%,134,80.72%,5,3.01%,4
719,9999.0,6,1,16.67%,1,16.67%,1,16.67%,0,0.00%,0
720,7681.0,61,58,95.08%,58,95.08%,58,95.08%,0,0.00%,0
721,9999.0,1,0,0.00%,0,0.00%,0,0.00%,0,0.00%,0
722,3434.0,227,156,68.72%,156,68.72%,157,69.16%,1,0.44%,0
723,3465.0,634,475,74.92%,468,73.82%,482,76.03%,7,1.10%,7
724,4957.0,444,357,80.41%,357,80.41%,364,81.98%,7,1.58%,0
725,9999.0,12,1,8.33%,1,8.33%,2,16.67%,1,8.33%,0
726,7634.0,153,136,88.89%,136,88.89%,136,88.89%,0,0.00%,0
727,3482.0,655,471,71.91%,467,71.30%,487,74.35%,16,2.44%,4
728,3495.0,356,292,82.02%,292,82.02%,299,83.99%,7,1.97%,0
729,9999.0,3,0,0.00%,0,0.00%,0,0.00%,0,0.00%,0
730,3505.0,461,367,79.61%,361,78.31%,375,81.34%,8,1.74%,6
731,6439.0,132,109,82.58%,107,81.06%,109,82.58%,0,0.00%,2
732,5352.0,162,128,79.01%,127,78.40%,130,80.25%,2,1.23%,1
733,9999.0,3,1,33.33%,1,33.33%,1,33.33%,0,0.00%,0
734,3522.0,159,127,79.87%,126,79.25%,129,81.13%,2,1.26%,1
735,9999.0,4,0,0.00%,0,0.00%,0,0.00%,0,0.00%,0
736,3532.0,85,46,54.12%,46,54.12%,46,54.12%,0,0.00%,0
737,3541.0,167,99,59.28%,99,59.28%,101,60.48%,2,1.20%,0
738,6936.0,82,49,59.76%,49,59.76%,50,60.98%,1,1.22%,0
739,9999.0,1,0,0.00%,0,0.00%,0,0.00%,0,0.00%,0
740,7893.0,145,88,60.69%,87,60.00%,89,61.38%,1,0.69%,1
741,9999.0,1,0,0.00%,0,0.00%,0,0.00%,0,0.00%,0
742,3569.0,150,90,60.00%,90,60.00%,91,60.67%,1,0.67%,0
743,5103.0,119,61,51.26%,61,51.26%,65,54.62%,4,3.36%,0
744,9999.0,1,0,0.00%,0,0.00%,0,0.00%,0,0.00%,0
745,6341.0,51,33,64.71%,33,64.71%,33,64.71%,0,0.00%,0
746,7930.0,76,52,68.42%,52,68.42%,52,68.42%,0,0.00%,0
747,3589.0,110,62,56.36%,62,56.36%,62,56.36%,0,0.00%,0
748,3596.0,178,111,62.36%,110,61.80%,113,63.48%,2,1.12%,1
749,9999.0,4,0,0.00%,0,0.00%,0,0.00%,0,0.00%,0
750,7744.0,64,34,53.13%,33,51.56%,34,53.13%,0,0.00%,1
751,8083.0,35,31,88.57%,31,88.57%,33,94.29%,2,5.71%,0
752,7678.0,64,47,73.44%,47,73.44%,53,82.81%,6,9.38%,0
753,7685.0,16,13,81.25%,13,81.25%,14,87.50%,1,6.25%,0
754,7737.0,146,92,63.01%,92,63.01%,100,68.49%,8,5.48%,0
755,9999.0,2,0,0.00%,0,0.00%,0,0.00%,0,0.00%,0
756,7777.0,62,45,72.58%,45,72.58%,46,74.19%,1,1.61%,0
757,7909.0,115,89,77.39%,89,77.39%,95,82.61%,6,5.22%,0
758,7910.0,89,64,71.91%,64,71.91%,70,78.65%,6,6.74%,0
759,8359.0,68,59,86.76%,51,75.00%,61,89.71%,2,2.94%,8
760,8216.0,43,24,55.81%,24,55.81%,32,74.42%,8,18.60%,0
761,7510.0,141,86,60.99%,86,60.99%,92,65.25%,6,4.26%,0
762,7513.0,110,9,8.18%,5,4.55%,10,9.09%,1,0.91%,4
763,7540.0,131,78,59.54%,78,59.54%,79,60.31%,1,0.76%,0
764,7542.0,127,83,65.35%,82,64.57%,85,66.93%,2,1.57%,1
765,7546.0,52,48,92.31%,48,92.31%,50,96.15%,2,3.85%,0
766,7574.0,98,90,91.84%,89,90.82%,91,92.86%,1,1.02%,1
767,7578.0,104,96,92.31%,96,92.31%,96,92.31%,0,0.00%,0
768,7582.0,69,62,89.86%,62,89.86%,68,98.55%,6,8.70%,0
769,7586.0,83,78,93.98%,78,93.98%,79,95.18%,1,1.20%,0
770,9999.0,2,0,0.00%,0,0.00%,0,0.00%,0,0.00%,0
771,7587.0,85,57,67.06%,57,67.06%,63,74.12%,6,7.06%,0
772,7588.0,79,46,58.23%,46,58.23%,46,58.23%,0,0.00%,0
773,7647.0,158,154,97.47%,154,97.47%,157,99.37%,3,1.90%,0
774,7649.0,169,137,81.07%,134,79.29%,141,83.43%,4,2.37%,3
775,7665.0,171,79,46.20%,79,46.20%,90,52.63%,11,6.43%,0
776,7666.0,257,197,76.65%,187,72.76%,197,76.65%,0,0.00%,10
777,8205.0,433,222,51.27%,221,51.04%,261,60.28%,39,9.01%,1
778,7672.0,132,92,69.70%,92,69.70%,93,70.45%,1,0.76%,0
779,9999.0,2,0,0.00%,0,0.00%,0,0.00%,0,0.00%,0
780,8207.0,178,131,73.60%,129,72.47%,148,83.15%,17,9.55%,2
781,8217.0,12,0,0.00%,0,0.00%,0,0.00%,0,0.00%,0
782,8358.0,107,91,85.05%,90,84.11%,100,93.46%,9,8.41%,1
783,3728.0,36,8,22.22%,7,19.44%,10,27.78%,2,5.56%,1
784,3808.0,110,108,98.18%,108,98.18%,108,98.18%,0,0.00%,0
785,3816.0,150,110,73.33%,99,66.00%,113,75.33%,3,2.00%,11
786,3818.0,135,85,62.96%,80,59.26%,87,64.44%,2,1.48%,5
787,3841.0,117,10,8.55%,10,8.55%,10,8.55%,0,0.00%,0
788,3842.0,128,58,45.31%,46,35.94%,61,47.66%,3,2.34%,12
789,3843.0,250,170,68.00%,164,65.60%,174,69.60%,4,1.60%,6
790,3844.0,135,82,60.74%,79,58.52%,84,62.22%,2,1.48%,3
791,3845.0,237,157,66.24%,141,59.49%,166,70.04%,9,3.80%,16
792,3847.0,96,26,27.08%,23,23.96%,30,31.25%,4,4.17%,3
793,3848.0,545,473,86.79%,471,86.42%,475,87.16%,2,0.37%,2
794,3849.0,114,42,36.84%,33,28.95%,45,39.47%,3,2.63%,9
795,3850.0,155,88,56.77%,84,54.19%,93,60.00%,5,3.23%,4
796,3851.0,83,36,43.37%,28,33.73%,41,49.40%,5,6.02%,8
797,3855.0,565,425,75.22%,407,72.04%,433,76.64%,8,1.42%,18
798,3857.0,76,48,63.16%,46,60.53%,48,63.16%,0,0.00%,2
799,3859.0,104,46,44.23%,44,42.31%,48,46.15%,2,1.92%,2
800,3860.0,81,10,12.35%,9,11.11%,11,13.58%,1,1.23%,1
801,3861.0,110,68,61.82%,65,59.09%,69,62.73%,1,0.91%,3
802,6527.0,262,160,61.07%,148,56.49%,163,62.21%,3,1.15%,12
803,6548.0,50,35,70.00%,34,68.00%,36,72.00%,1,2.00%,1
804,6675.0,98,38,38.78%,33,33.67%,42,42.86%,4,4.08%,5
805,6822.0,202,133,65.84%,125,61.88%,135,66.83%,2,0.99%,8
806,6996.0,168,29,17.26%,29,17.26%,30,17.86%,1,0.60%,0
807,7023.0,212,189,89.15%,184,86.79%,191,90.09%,2,0.94%,5
808,7070.0,95,81,85.26%,80,84.21%,82,86.32%,1,1.05%,1
809,7072.0,162,110,67.90%,95,58.64%,121,74.69%,11,6.79%,15
810,7229.0,95,64,67.37%,63,66.32%,64,67.37%,0,0.00%,1
811,7245.0,53,28,52.83%,26,49.06%,30,56.60%,2,3.77%,2
812,7255.0,47,24,51.06%,21,44.68%,26,55.32%,2,4.26%,3
813,7664.0,61,56,91.80%,55,90.16%,57,93.44%,1,1.64%,1
814,7780.0,70,58,82.86%,55,78.57%,58,82.86%,0,0.00%,3
815,7782.0,108,93,86.11%,88,81.48%,93,86.11%,0,0.00%,5
816,7808.0,52,41,78.85%,38,73.08%,43,82.69%,2,3.85%,3
817,7811.0,72,36,50.00%,34,47.22%,37,51.39%,1,1.39%,2
818,7813.0,76,40,52.63%,32,42.11%,42,55.26%,2,2.63%,8
819,7815.0,83,45,54.22%,38,45.78%,49,59.04%,4,4.82%,7
820,7850.0,43,29,67.44%,24,55.81%,31,72.09%,2,4.65%,5
821,7852.0,91,55,60.44%,49,53.85%,58,63.74%,3,3.30%,6
822,7855.0,80,15,18.75%,15,18.75%,16,20.00%,1,1.25%,0
823,7903.0,91,53,58.24%,52,57.14%,54,59.34%,1,1.10%,1
824,7904.0,225,208,92.44%,203,90.22%,212,94.22%,4,1.78%,5
825,7905.0,105,86,81.90%,80,76.19%,87,82.86%,1,0.95%,6
826,7906.0,120,104,86.67%,103,85.83%,104,86.67%,0,0.00%,1
827,8039.0,141,127,90.07%,124,87.94%,131,92.91%,4,2.84%,3
828,8293.0,65,25,38.46%,22,33.85%,29,44.62%,4,6.15%,3
829,8298.0,70,34,48.57%,32,45.71%,38,54.29%,4,5.71%,2
830,8328.0,56,40,71.43%,38,67.86%,41,73.21%,1,1.79%,2
831,8329.0,43,31,72.09%,29,67.44%,34,79.07%,3,6.98%,2
832,8330.0,113,98,86.73%,97,85.84%,100,88.50%,2,1.77%,1
833,8331.0,40,25,62.50%,25,62.50%,25,62.50%,0,0.00%,0
834,8332.0,65,43,66.15%,41,63.08%,47,72.31%,4,6.15%,2
835,8385.0,13,0,0.00%,0,0.00%,0,0.00%,0,0.00%,0
836,8386.0,13,8,61.54%,7,53.85%,8,61.54%,0,0.00%,1
837,8388.0,72,27,37.50%,24,33.33%,29,40.28%,2,2.78%,3
838,9999.0,918,62,6.75%,53,5.77%,68,7.41%,6,0.65%,9
839,8195.0,80,0,0.00%,0,0.00%,0,0.00%,0,0.00%,0
840,7961.0,79,59,74.68%,56,70.89%,60,75.95%,1,1.27%,3
841,8127.0,39,39,100.00%,39,100.00%,39,100.00%,0,0.00%,0
842,8148.0,91,40,43.96%,40,43.96%,46,50.55%,6,6.59%,0
843,7981.0,67,47,70.15%,47,70.15%,49,73.13%,2,2.99%,0
844,8126.0,96,79,82.29%,79,82.29%,93,96.88%,14,14.58%,0
845,4310.0,281,178,63.35%,174,61.92%,186,66.19%,8,2.85%,4
846,5261.0,361,272,75.35%,269,74.52%,285,78.95%,13,3.60%,3
847,6222.0,16,11,68.75%,10,62.50%,11,68.75%,0,0.00%,1
848,3869.0,65,34,52.31%,34,52.31%,36,55.38%,2,3.08%,0
849,6223.0,30,18,60.00%,18,60.00%,19,63.33%,1,3.33%,0
850,3875.0,32,15,46.88%,13,40.63%,15,46.88%,0,0.00%,2
851,3877.0,43,23,53.49%,23,53.49%,24,55.81%,1,2.33%,0
852,3891.0,202,125,61.88%,110,54.46%,127,62.87%,2,0.99%,15
853,9999.0,2,0,0.00%,0,0.00%,0,0.00%,0,0.00%,0
854,8403.0,76,52,68.42%,48,63.16%,52,68.42%,0,0.00%,4
855,6583.0,84,61,72.62%,51,60.71%,62,73.81%,1,1.19%,10
856,8161.0,14,7,50.00%,7,50.00%,7,50.00%,0,0.00%,0
857,3883.0,131,88,67.18%,88,67.18%,88,67.18%,0,0.00%,0
858,3910.0,116,63,54.31%,63,54.31%,65,56.03%,2,1.72%,0
859,3924.0,202,109,53.96%,104,51.49%,117,57.92%,8,3.96%,5
860,9999.0,1,0,0.00%,0,0.00%,0,0.00%,0,0.00%,0
861,3940.0,82,48,58.54%,44,53.66%,49,59.76%,1,1.22%,4
862,5264.0,98,64,65.31%,54,55.10%,64,65.31%,0,0.00%,10
863,5070.0,128,103,80.47%,97,75.78%,110,85.94%,7,5.47%,6
864,3957.0,64,44,68.75%,39,60.94%,44,68.75%,0,0.00%,5
865,9999.0,1,0,0.00%,0,0.00%,0,0.00%,0,0.00%,0
866,3914.0,62,35,56.45%,33,53.23%,39,62.90%,4,6.45%,2
867,3962.0,143,68,47.55%,66,46.15%,72,50.35%,4,2.80%,2
868,9999.0,1,0,0.00%,0,0.00%,0,0.00%,0,0.00%,0
869,3969.0,188,126,67.02%,126,67.02%,126,67.02%,0,0.00%,0
870,9999.0,1,0,0.00%,0,0.00%,0,0.00%,0,0.00%,0
871,6207.0,59,31,52.54%,31,52.54%,35,59.32%,4,6.78%,0
872,3978.0,91,45,49.45%,42,46.15%,50,54.95%,5,5.49%,3
873,3994.0,69,29,42.03%,28,40.58%,29,42.03%,0,0.00%,1
874,3988.0,81,35,43.21%,34,41.98%,39,48.15%,4,4.94%,1
875,6210.0,62,30,48.39%,27,43.55%,30,48.39%,0,0.00%,3
876,4002.0,18,6,33.33%,5,27.78%,6,33.33%,0,0.00%,1
877,4006.0,37,19,51.35%,19,51.35%,21,56.76%,2,5.41%,0
878,6800.0,26,16,61.54%,16,61.54%,16,61.54%,0,0.00%,0
879,9999.0,1,0,0.00%,0,0.00%,0,0.00%,0,0.00%,0
880,8274.0,186,111,59.68%,103,55.38%,111,59.68%,0,0.00%,8
881,6216.0,30,14,46.67%,14,46.67%,14,46.67%,0,0.00%,0
882,4026.0,88,59,67.05%,55,62.50%,62,70.45%,3,3.41%,4
883,9999.0,1,0,0.00%,0,0.00%,0,0.00%,0,0.00%,0
884,4030.0,50,30,60.00%,30,60.00%,33,66.00%,3,6.00%,0
885,4034.0,61,44,72.13%,44,72.13%,44,72.13%,0,0.00%,0
886,6418.0,76,47,61.84%,46,60.53%,48,63.16%,1,1.32%,1
887,6419.0,64,50,78.13%,50,78.13%,50,78.13%,0,0.00%,0
888,4044.0,116,72,62.07%,69,59.48%,74,63.79%,2,1.72%,3
889,4049.0,67,31,46.27%,31,46.27%,34,50.75%,3,4.48%,0
890,9999.0,2,0,0.00%,0,0.00%,0,0.00%,0,0.00%,0
891,4054.0,59,35,59.32%,35,59.32%,36,61.02%,1,1.69%,0
892,4058.0,70,37,52.86%,37,52.86%,39,55.71%,2,2.86%,0
893,6373.0,83,46,55.42%,46,55.42%,52,62.65%,6,7.23%,0
894,4064.0,59,29,49.15%,29,49.15%,32,54.24%,3,5.08%,0
895,4068.0,98,54,55.10%,51,52.04%,56,57.14%,2,2.04%,3
896,4080.0,120,61,50.83%,59,49.17%,64,53.33%,3,2.50%,2
897,4085.0,148,118,79.73%,118,79.73%,118,79.73%,0,0.00%,0
898,9999.0,4,0,0.00%,0,0.00%,0,0.00%,0,0.00%,0
899,4091.0,163,88,53.99%,86,52.76%,94,57.67%,6,3.68%,2
900,4098.0,72,40,55.56%,38,52.78%,42,58.33%,2,2.78%,2
901,9999.0,1,0,0.00%,0,0.00%,0,0.00%,0,0.00%,0
902,4106.0,137,64,46.72%,63,45.99%,74,54.01%,10,7.30%,1
903,9999.0,4,0,0.00%,0,0.00%,0,0.00%,0,0.00%,0
904,4931.0,142,77,54.23%,75,52.82%,80,56.34%,3,2.11%,2
905,9999.0,10,0,0.00%,0,0.00%,0,0.00%,0,0.00%,0
906,1668.0,134,67,50.00%,60,44.78%,81,60.45%,14,10.45%,7
907,4126.0,79,47,59.49%,29,36.71%,47,59.49%,0,0.00%,18
908,7833.0,21,8,38.10%,8,38.10%,8,38.10%,0,0.00%,0
909,4135.0,57,24,42.11%,23,40.35%,25,43.86%,1,1.75%,1
910,4143.0,76,43,56.58%,37,48.68%,44,57.89%,1,1.32%,6
911,4146.0,35,15,42.86%,14,40.00%,16,45.71%,1,2.86%,1
912,4149.0,181,95,52.49%,90,49.72%,99,54.70%,4,2.21%,5
913,4165.0,42,30,71.43%,23,54.76%,30,71.43%,0,0.00%,7
914,4188.0,77,43,55.84%,43,55.84%,58,75.32%,15,19.48%,0
915,9999.0,1,0,0.00%,0,0.00%,0,0.00%,0,0.00%,0
916,4181.0,104,70,67.31%,61,58.65%,72,69.23%,2,1.92%,9
917,9999.0,1,0,0.00%,0,0.00%,0,0.00%,0,0.00%,0
918,4195.0,69,43,62.32%,43,62.32%,47,68.12%,4,5.80%,0
919,9999.0,1,0,0.00%,0,0.00%,0,0.00%,0,0.00%,0
920,4203.0,59,37,62.71%,37,62.71%,47,79.66%,10,16.95%,0
921,4217.0,357,270,75.63%,270,75.63%,270,75.63%,0,0.00%,0
922,9999.0,8,0,0.00%,0,0.00%,0,0.00%,0,0.00%,0
923,4715.0,93,63,67.74%,63,67.74%,63,67.74%,0,0.00%,0
924,9999.0,2,0,0.00%,0,0.00%,0,0.00%,0,0.00%,0
925,4235.0,70,50,71.43%,44,62.86%,55,78.57%,5,7.14%,6
926,4242.0,80,54,67.50%,51,63.75%,54,67.50%,0,0.00%,3
927,9999.0,2,0,0.00%,0,0.00%,0,0.00%,0,0.00%,0
928,4249.0,106,56,52.83%,51,48.11%,63,59.43%,7,6.60%,5
929,9999.0,2,0,0.00%,0,0.00%,0,0.00%,0,0.00%,0
930,5083.0,372,345,92.74%,345,92.74%,354,95.16%,9,2.42%,0
931,9999.0,6,0,0.00%,0,0.00%,0,0.00%,0,0.00%,0
932,7019.0,217,115,53.00%,113,52.07%,121,55.76%,6,2.76%,2
933,9999.0,11,0,0.00%,0,0.00%,0,0.00%,0,0.00%,0
934,6012.0,249,178,71.49%,174,69.88%,178,71.49%,0,0.00%,4
935,4286.0,108,56,51.85%,53,49.07%,57,52.78%,1,0.93%,3
936,9999.0,3,0,0.00%,0,0.00%,0,0.00%,0,0.00%,0
937,4295.0,167,101,60.48%,99,59.28%,106,63.47%,5,2.99%,2
938,9999.0,5,3,60.00%,3,60.00%,3,60.00%,0,0.00%,0
939,6704.0,153,102,66.67%,102,66.67%,105,68.63%,3,1.96%,0
940,9999.0,2,0,0.00%,0,0.00%,0,0.00%,0,0.00%,0
941,4930.0,185,126,68.11%,118,63.78%,135,72.97%,9,4.86%,8
942,9999.0,1,0,0.00%,0,0.00%,0,0.00%,0,0.00%,0
943,4340.0,143,114,79.72%,113,79.02%,115,80.42%,1,0.70%,1
944,4352.0,150,109,72.67%,94,62.67%,110,73.33%,1,0.67%,15
945,9999.0,6,0,0.00%,0,0.00%,0,0.00%,0,0.00%,0
946,4360.0,289,250,86.51%,249,86.16%,252,87.20%,2,0.69%,1
947,9999.0,2,0,0.00%,0,0.00%,0,0.00%,0,0.00%,0
948,7550.0,42,24,57.14%,24,57.14%,32,76.19%,8,19.05%,0
949,4845.0,303,234,77.23%,227,74.92%,237,78.22%,3,0.99%,7
950,9999.0,5,0,0.00%,0,0.00%,0,0.00%,0,0.00%,0
951,4373.0,185,136,73.51%,135,72.97%,136,73.51%,0,0.00%,1
952,4404.0,427,337,78.92%,327,76.58%,344,80.56%,7,1.64%,10
953,9999.0,2,0,0.00%,0,0.00%,0,0.00%,0,0.00%,0
954,8421.0,50,36,72.00%,28,56.00%,36,72.00%,0,0.00%,8
955,9999.0,3,2,66.67%,1,33.33%,2,66.67%,0,0.00%,1
956,4431.0,292,188,64.38%,182,62.33%,193,66.10%,5,1.71%,6
957,4442.0,130,96,73.85%,90,69.23%,100,76.92%,4,3.08%,6
958,9999.0,3,0,0.00%,0,0.00%,0,0.00%,0,0.00%,0
959,6181.0,52,0,0.00%,0,0.00%,0,0.00%,0,0.00%,0
960,9999.0,1,0,0.00%,0,0.00%,0,0.00%,0,0.00%,0
961,4458.0,149,0,0.00%,0,0.00%,0,0.00%,0,0.00%,0
962,9999.0,9,0,0.00%,0,0.00%,0,0.00%,0,0.00%,0
963,8323.0,119,69,57.98%,65,54.62%,77,64.71%,8,6.72%,4
964,9999.0,2,0,0.00%,0,0.00%,0,0.00%,0,0.00%,0
965,4717.0,387,311,80.36%,303,78.29%,314,81.14%,3,0.78%,8
966,9999.0,4,0,0.00%,0,0.00%,0,0.00%,0,0.00%,0
967,6648.0,314,268,85.35%,263,83.76%,270,85.99%,2,0.64%,5
968,6191.0,122,63,51.64%,59,48.36%,65,53.28%,2,1.64%,4
969,9999.0,6,0,0.00%,0,0.00%,0,0.00%,0,0.00%,0
970,4735.0,145,97,66.90%,97,66.90%,105,72.41%,8,5.52%,0
971,9999.0,1,0,0.00%,0,0.00%,0,0.00%,0,0.00%,0
972,5271.0,198,110,55.56%,110,55.56%,123,62.12%,13,6.57%,0
973,4528.0,60,39,65.00%,39,65.00%,40,66.67%,1,1.67%,0
974,9999.0,1,0,0.00%,0,0.00%,0,0.00%,0,0.00%,0
975,4545.0,481,373,77.55%,356,74.01%,385,80.04%,12,2.49%,17
976,9999.0,5,0,0.00%,0,0.00%,0,0.00%,0,0.00%,0
977,4553.0,494,380,76.92%,372,75.30%,389,78.74%,9,1.82%,8
978,9999.0,12,4,33.33%,2,16.67%,4,33.33%,0,0.00%,2
979,4558.0,230,146,63.48%,141,61.30%,151,65.65%,5,2.17%,5
980,9999.0,2,0,0.00%,0,0.00%,0,0.00%,0,0.00%,0
981,4564.0,143,94,65.73%,86,60.14%,97,67.83%,3,2.10%,8
982,9999.0,5,0,0.00%,0,0.00%,0,0.00%,0,0.00%,0
983,4571.0,109,55,50.46%,55,50.46%,55,50.46%,0,0.00%,0
984,9999.0,15,1,6.67%,1,6.67%,1,6.67%,0,0.00%,0
985,7624.0,62,0,0.00%,0,0.00%,0,0.00%,0,0.00%,0
986,4577.0,262,190,72.52%,185,70.61%,195,74.43%,5,1.91%,5
987,9999.0,2,0,0.00%,0,0.00%,0,0.00%,0,0.00%,0
988,4598.0,355,234,65.92%,225,63.38%,243,68.45%,9,2.54%,9
989,9999.0,16,0,0.00%,0,0.00%,0,0.00%,0,0.00%,0
990,4602.0,173,122,70.52%,118,68.21%,124,71.68%,2,1.16%,4
991,9999.0,7,0,0.00%,0,0.00%,3,42.86%,3,42.86%,0
992,4608.0,280,183,65.36%,180,64.29%,196,70.00%,13,4.64%,3
993,9999.0,11,0,0.00%,0,0.00%,0,0.00%,0,0.00%,0
994,4614.0,228,182,79.82%,182,79.82%,186,81.58%,4,1.75%,0
995,9999.0,7,1,14.29%,1,14.29%,1,14.29%,0,0.00%,0
996,4623.0,253,153,60.47%,145,57.31%,158,62.45%,5,1.98%,8
997,9999.0,2,0,0.00%,0,0.00%,0,0.00%,0,0.00%,0
998,6705.0,191,142,74.35%,138,72.25%,150,78.53%,8,4.19%,4
999,9999.0,14,1,7.14%,1,7.14%,1,7.14%,0,0.00%,0
1000,4647.0,234,196,83.76%,192,82.05%,200,85.47%,4,1.71%,4
1001,9999.0,9,0,0.00%,0,0.00%,0,0.00%,0,0.00%,0
1002,5168.0,350,130,37.14%,124,35.43%,132,37.71%,2,0.57%,6
1003,4658.0,192,158,82.29%,158,82.29%,162,84.38%,4,2.08%,0
1004,9999.0,13,5,38.46%,4,30.77%,6,46.15%,1,7.69%,1
1005,1732.0,292,189,64.73%,189,64.73%,189,64.73%,0,0.00%,0
1006,4704.0,277,193,69.68%,189,68.23%,194,70.04%,1,0.36%,4
1007,9999.0,3,0,0.00%,0,0.00%,0,0.00%,0,0.00%,0
1008,6345.0,231,171,74.03%,165,71.43%,174,75.32%,3,1.30%,6
1009,9999.0,6,0,0.00%,0,0.00%,1,16.67%,1,16.67%,0
1010,,"125,515","84,445",67.28%,"82,185",65.48%,"87,062",69.36%,"2,617",2.09%,"2,260"
1011,,,- 2 -,,,,,www.pimsreports.pa.gov,,,
