County,AUN,LEA,Total Graduates,Total College-Bound,Total College-Bound %,2- or 4-Year College or University,2- or 4-Year College or University %,Total Postsec Bound,Total Postsec Bound %,Non-Degree-Granting Postsec School,Non-Degree-Granting Postsec School %,Specialized Associate Degree-Granting Institution,Specialized Associate Degree-Granting Institution %
Lackawanna,119350303,Abington Heights SD,298,257,86.2%,250,83.9%,261,87.6%,4,1.3%,7,2.3%
Montgomery,123460302,Abington SD,582,521,89.5%,515,88.5%,528,90.7%,7,1.2%,6,1.0%
Fayette,101260303,Albert Gallatin Area SD,261,121,46.4%,85,32.6%,126,48.3%,5,1.9%,36,13.8%
Beaver,127040503,Aliquippa SD,74,40,54.1%,40,54.1%,41,55.4%,1,1.4%,0,0.0%
Allegheny,103020603,Allegheny Valley SD,91,67,73.6%,61,67.0%,69,75.8%,2,2.2%,6,6.6%
Clarion,106160303,Allegheny-Clarion Valley SD,68,41,60.3%,37,54.4%,41,60.3%,0,0.0%,4,5.9%
Lehigh,121390302,Allentown City SD,1073,604,56.3%,573,53.4%,644,60.0%,40,3.7%,31,2.9%
Blair,108070502,Altoona Area SD,515,329,63.9%,301,58.4%,339,65.8%,10,1.9%,28,5.4%
Beaver,127040703,Ambridge Area SD,168,112,66.7%,104,61.9%,112,66.7%,0,0.0%,8,4.8%
Lebanon,113380303,Annville-Cleona SD,110,65,59.1%,65,59.1%,69,62.7%,4,3.6%,0,0.0%
Berks,114060503,Antietam SD,76,65,85.5%,56,73.7%,65,85.5%,0,0.0%,9,11.8%
Armstrong,128030603,Apollo-Ridge SD,84,59,70.2%,52,61.9%,63,75.0%,4,4.8%,7,8.3%
Armstrong,128030852,Armstrong SD,311,215,69.1%,198,63.7%,219,70.4%,4,1.3%,17,5.5%
Bradford,117080503,Athens Area SD,140,66,47.1%,65,46.4%,66,47.1%,0,0.0%,1,0.7%
Potter,109530304,Austin Area SD,16,10,62.5%,10,62.5%,11,68.8%,1,6.3%,0,0.0%
Washington,101630504,Avella Area SD,51,38,74.5%,38,74.5%,38,74.5%,0,0.0%,0,0.0%
Chester,124150503,Avon Grove SD,418,320,76.6%,316,75.6%,327,78.2%,7,1.7%,4,1.0%
Allegheny,103020753,Avonworth SD,101,82,81.2%,82,81.2%,85,84.2%,3,3.0%,0,0.0%
Centre,110141003,Bald Eagle Area SD,146,93,63.7%,78,53.4%,96,65.8%,3,2.1%,15,10.3%
Allegheny,103021102,Baldwin-Whitehall SD,366,311,85.0%,301,82.2%,319,87.2%,8,2.2%,10,2.7%
Northampton,120480803,Bangor Area SD,268,203,75.7%,202,75.4%,207,77.2%,4,1.5%,1,0.4%
Beaver,127041203,Beaver Area SD,162,134,82.7%,129,79.6%,136,84.0%,2,1.2%,5,3.1%
Bedford,108051003,Bedford Area SD,151,82,54.3%,79,52.3%,84,55.6%,2,1.3%,3,2.0%
Westmoreland,107650603,Belle Vernon Area SD,205,141,68.8%,135,65.9%,149,72.7%,8,3.9%,6,2.9%
Centre,110141103,Bellefonte Area SD,222,149,67.1%,134,60.4%,158,71.2%,9,4.1%,15,6.8%
Blair,108071003,Bellwood-Antis SD,104,69,66.3%,69,66.3%,82,78.8%,13,12.5%,0,0.0%
Bucks,122091002,Bensalem Township SD,446,341,76.5%,341,76.5%,369,82.7%,28,6.3%,0,0.0%
Columbia,116191004,Benton Area SD,49,26,53.1%,26,53.1%,27,55.1%,1,2.0%,0,0.0%
Washington,101630903,Bentworth SD,89,61,68.5%,53,59.6%,61,68.5%,0,0.0%,8,9.0%
Somerset,108561003,Berlin Brothersvalley SD,70,41,58.6%,36,51.4%,44,62.9%,3,4.3%,5,7.1%
Adams,112011103,Bermudian Springs SD,136,100,73.5%,99,72.8%,100,73.5%,0,0.0%,1,0.7%
Columbia,116191103,Berwick Area SD,234,171,73.1%,170,72.6%,175,74.8%,4,1.7%,1,0.4%
Allegheny,103021252,Bethel Park SD,412,356,86.4%,345,83.7%,357,86.7%,1,0.2%,11,2.7%
Northampton,120481002,Bethlehem Area SD,1069,900,84.2%,884,82.7%,909,85.0%,9,0.8%,16,1.5%
Washington,101631003,Bethlehem-Center SD,86,55,64.0%,51,59.3%,62,72.1%,7,8.1%,4,4.7%
Beaver,127041503,Big Beaver Falls Area SD,132,80,60.6%,70,53.0%,81,61.4%,1,0.8%,10,7.6%
Cumberland,115210503,Big Spring SD,205,121,59.0%,115,56.1%,123,60.0%,2,1.0%,6,2.9%
Beaver,127041603,Blackhawk SD,207,163,78.7%,156,75.4%,177,85.5%,14,6.8%,7,3.4%
Cambria,108110603,Blacklick Valley SD,40,28,70.0%,24,60.0%,30,75.0%,2,5.0%,4,10.0%
Indiana,128321103,Blairsville-Saltsburg SD,147,105,71.4%,95,64.6%,107,72.8%,2,1.4%,10,6.8%
Columbia,116191203,Bloomsburg Area SD,94,71,75.5%,68,72.3%,75,79.8%,4,4.3%,3,3.2%
Schuylkill,129540803,Blue Mountain SD,230,160,69.6%,146,63.5%,170,73.9%,10,4.3%,14,6.1%
Susquehanna,119581003,Blue Ridge SD,77,39,50.6%,39,50.6%,42,54.5%,3,3.9%,0,0.0%
Berks,114060753,Boyertown Area SD,538,432,80.3%,410,76.2%,435,80.9%,3,0.6%,22,4.1%
McKean,109420803,Bradford Area SD,210,142,67.6%,127,60.5%,151,71.9%,9,4.3%,15,7.1%
Berks,114060853,Brandywine Heights Area SD,152,110,72.4%,104,68.4%,113,74.3%,3,2.0%,6,3.9%
Allegheny,103021453,Brentwood Borough SD,113,96,85.0%,90,79.6%,98,86.7%,2,1.8%,6,5.3%
Bucks,122091303,Bristol Borough SD,75,52,69.3%,52,69.3%,60,80.0%,8,10.7%,0,0.0%
Bucks,122091352,Bristol Township SD,426,299,70.2%,279,65.5%,308,72.3%,9,2.1%,20,4.7%
Jefferson,106330703,Brockway Area SD,94,62,66.0%,60,63.8%,62,66.0%,0,0.0%,2,2.1%
Jefferson,106330803,Brookville Area SD,111,77,69.4%,75,67.6%,82,73.9%,5,4.5%,2,1.8%
Fayette,101260803,Brownsville Area SD,103,73,70.9%,67,65.0%,73,70.9%,0,0.0%,6,5.8%
Washington,101631203,Burgettstown Area SD,83,54,65.1%,54,65.1%,61,73.5%,7,8.4%,0,0.0%
Westmoreland,107650703,Burrell SD,149,126,84.6%,120,80.5%,128,85.9%,2,1.3%,6,4.0%
Butler,104101252,Butler Area SD,599,452,75.5%,433,72.3%,463,77.3%,11,1.8%,19,3.2%
Washington,101631503,California Area SD,63,46,73.0%,45,71.4%,47,74.6%,1,1.6%,1,1.6%
Cambria,108111203,Cambria Heights SD,112,76,67.9%,68,60.7%,79,70.5%,3,2.7%,8,7.1%
Cameron,109122703,Cameron County SD,53,31,58.5%,27,50.9%,32,60.4%,1,1.9%,4,7.5%
Cumberland,115211003,Camp Hill SD,106,101,95.3%,98,92.5%,101,95.3%,0,0.0%,3,2.8%
Washington,101631703,Canon-McMillan SD,341,281,82.4%,243,71.3%,285,83.6%,4,1.2%,38,11.1%
Bradford,117081003,Canton Area SD,76,39,51.3%,39,51.3%,39,51.3%,0,0.0%,0,0.0%
Lackawanna,119351303,Carbondale Area SD,95,67,70.5%,64,67.4%,76,80.0%,9,9.5%,3,3.2%
Cumberland,115211103,Carlisle Area SD,337,223,66.2%,194,57.6%,223,66.2%,0,0.0%,29,8.6%
Allegheny,103021603,Carlynton SD,109,78,71.6%,70,64.2%,78,71.6%,0,0.0%,8,7.3%
Greene,101301303,Carmichaels Area SD,58,38,65.5%,37,63.8%,38,65.5%,0,0.0%,1,1.7%
Lehigh,121391303,Catasauqua Area SD,123,97,78.9%,90,73.2%,99,80.5%,2,1.6%,7,5.7%
Bucks,122092002,Centennial SD,426,347,81.5%,343,80.5%,359,84.3%,12,2.8%,4,0.9%
Bucks,122092102,Central Bucks SD,1575,1431,90.9%,1419,90.1%,1437,91.2%,6,0.4%,12,0.8%
Cambria,108111303,Central Cambria SD,160,120,75.0%,110,68.8%,123,76.9%,3,1.9%,10,6.3%
Columbia,116191503,Central Columbia SD,159,124,78.0%,124,78.0%,124,78.0%,0,0.0%,0,0.0%
Dauphin,115221402,Central Dauphin SD,755,598,79.2%,582,77.1%,611,80.9%,13,1.7%,16,2.1%
Fulton,111291304,Central Fulton SD,54,38,70.4%,36,66.7%,38,70.4%,0,0.0%,2,3.7%
Greene,101301403,Central Greene SD,151,85,56.3%,76,50.3%,85,56.3%,0,0.0%,9,6.0%
Beaver,127042003,Central Valley SD,187,154,82.4%,147,78.6%,158,84.5%,4,2.1%,7,3.7%
York,112671303,Central York SD,409,334,81.7%,311,76.0%,341,83.4%,7,1.7%,23,5.6%
Franklin,112281302,Chambersburg Area SD,596,319,53.5%,310,52.0%,325,54.5%,6,1.0%,9,1.5%
Washington,101631803,Charleroi SD,136,98,72.1%,73,53.7%,100,73.5%,2,1.5%,25,18.4%
Allegheny,103021752,Chartiers Valley SD,273,242,88.6%,234,85.7%,245,89.7%,3,1.1%,8,2.9%
Washington,101631903,Chartiers-Houston SD,87,63,72.4%,58,66.7%,63,72.4%,0,0.0%,5,5.7%
Montgomery,123461302,Cheltenham Township SD,346,285,82.4%,283,81.8%,288,83.2%,3,0.9%,2,0.6%
Delaware,125231232,Chester-Upland SD,312,203,65.1%,202,64.7%,204,65.4%,1,0.3%,1,0.3%
Bedford,108051503,Chestnut Ridge SD,113,58,51.3%,42,37.2%,65,57.5%,7,6.2%,16,14.2%
Delaware,125231303,Chichester SD,241,150,62.2%,143,59.3%,165,68.5%,15,6.2%,7,2.9%
Allegheny,103021903,Clairton City SD,41,23,56.1%,21,51.2%,24,58.5%,1,2.4%,2,4.9%
Clarion,106161203,Clarion Area SD,51,42,82.4%,42,82.4%,42,82.4%,0,0.0%,0,0.0%
Clarion,106161703,Clarion-Limestone Area SD,90,59,65.6%,57,63.3%,65,72.2%,6,6.7%,2,2.2%
Blair,108071504,Claysburg-Kimmel SD,69,0,0.0%,0,0.0%,0,0.0%,0,0.0%,0,0.0%
Clearfield,110171003,Clearfield Area SD,205,102,49.8%,86,42.0%,116,56.6%,14,6.8%,16,7.8%
Chester,124151902,Coatesville Area SD,546,357,65.4%,357,65.4%,430,78.8%,73,13.4%,0,0.0%
Lancaster,113361303,Cocalico SD,285,148,51.9%,142,49.8%,151,53.0%,3,1.1%,6,2.1%
Montgomery,123461602,Colonial SD,409,363,88.8%,361,88.3%,367,89.7%,4,1.0%,2,0.5%
Lancaster,113361503,Columbia Borough SD,82,48,58.5%,39,47.6%,50,61.0%,2,2.4%,9,11.0%
Mercer,104431304,Commodore Perry SD,43,29,67.4%,28,65.1%,31,72.1%,2,4.7%,1,2.3%
Somerset,108561803,Conemaugh Township Area SD,78,54,69.2%,50,64.1%,56,71.8%,2,2.6%,4,5.1%
Cambria,108111403,Conemaugh Valley SD,69,54,78.3%,51,73.9%,58,84.1%,4,5.8%,3,4.3%
Lancaster,113361703,Conestoga Valley SD,315,216,68.6%,213,67.6%,219,69.5%,3,1.0%,3,1.0%
Adams,112011603,Conewago Valley SD,307,212,69.1%,183,59.6%,213,69.4%,1,0.3%,29,9.4%
Crawford,105201033,Conneaut SD,204,113,55.4%,98,48.0%,129,63.2%,16,7.8%,15,7.4%
Fayette,101261302,Connellsville Area SD,255,167,65.5%,166,65.1%,191,74.9%,24,9.4%,1,0.4%
Berks,114061103,Conrad Weiser Area SD,253,174,68.8%,163,64.4%,198,78.3%,24,9.5%,11,4.3%
Allegheny,103022103,Cornell SD,60,53,88.3%,50,83.3%,54,90.0%,1,1.7%,3,5.0%
Lebanon,113381303,Cornwall-Lebanon SD,384,288,75.0%,265,69.0%,296,77.1%,8,2.1%,23,6.0%
Erie,105251453,Corry Area SD,204,98,48.0%,84,41.2%,111,54.4%,13,6.4%,14,6.9%
Potter,109531304,Coudersport Area SD,62,30,48.4%,30,48.4%,32,51.6%,2,3.2%,0,0.0%
Bucks,122092353,Council Rock SD,1053,988,93.8%,987,93.7%,1003,95.3%,15,1.4%,1,0.1%
Venango,106611303,Cranberry Area SD,87,54,62.1%,44,50.6%,57,65.5%,3,3.4%,10,11.5%
Crawford,105201352,Crawford Central SD,302,196,64.9%,176,58.3%,201,66.6%,5,1.7%,20,6.6%
Luzerne,118401403,Crestwood SD,265,233,87.9%,225,84.9%,233,87.9%,0,0.0%,8,3.0%
Cumberland,115211603,Cumberland Valley SD,596,475,79.7%,472,79.2%,478,80.2%,3,0.5%,3,0.5%
Clearfield,110171803,Curwensville Area SD,72,45,62.5%,37,51.4%,49,68.1%,4,5.6%,8,11.1%
Luzerne,118401603,Dallas SD,215,183,85.1%,179,83.3%,186,86.5%,3,1.4%,4,1.9%
York,112671603,Dallastown Area SD,473,343,72.5%,331,70.0%,360,76.1%,17,3.6%,12,2.5%
Berks,114061503,Daniel Boone Area SD,268,0,0.0%,0,0.0%,0,0.0%,0,0.0%,0,0.0%
Montour,116471803,Danville Area SD,188,144,76.6%,136,72.3%,148,78.7%,4,2.1%,8,4.3%
Allegheny,103022253,Deer Lakes SD,136,102,75.0%,102,75.0%,112,82.4%,10,7.4%,0,0.0%
Pike,120522003,Delaware Valley SD,416,364,87.5%,317,76.2%,366,88.0%,2,0.5%,47,11.3%
Westmoreland,107651603,Derry Area SD,171,126,73.7%,112,65.5%,130,76.0%,4,2.3%,14,8.2%
Dauphin,115221753,Derry Township SD,259,235,90.7%,233,90.0%,239,92.3%,4,1.5%,2,0.8%
Lancaster,113362203,Donegal SD,220,147,66.8%,136,61.8%,149,67.7%,2,0.9%,11,5.0%
York,112671803,Dover Area SD,218,146,67.0%,137,62.8%,154,70.6%,8,3.7%,9,4.1%
Chester,124152003,Downingtown Area SD,858,768,89.5%,768,89.5%,784,91.4%,16,1.9%,0,0.0%
Clearfield,106172003,Dubois Area SD,278,188,67.6%,171,61.5%,194,69.8%,6,2.2%,17,6.1%
Lackawanna,119352203,Dunmore SD,120,97,80.8%,91,75.8%,100,83.3%,3,2.5%,6,5.0%
Allegheny,103022803,East Allegheny SD,151,103,68.2%,96,63.6%,113,74.8%,10,6.6%,7,4.6%
Lycoming,117412003,East Lycoming SD,131,97,74.0%,88,67.2%,97,74.0%,0,0.0%,9,6.9%
Lehigh,121392303,East Penn SD,607,488,80.4%,486,80.1%,496,81.7%,8,1.3%,2,0.3%
Cumberland,115212503,East Pennsboro Area SD,198,158,79.8%,152,76.8%,159,80.3%,1,0.5%,6,3.0%
Monroe,120452003,East Stroudsburg Area SD,647,493,76.2%,493,76.2%,538,83.2%,45,7.0%,0,0.0%
Lancaster,113362303,Eastern Lancaster County SD,274,174,63.5%,153,55.8%,177,64.6%,3,1.1%,21,7.7%
Lebanon,113382303,Eastern Lebanon County SD,174,119,68.4%,118,67.8%,122,70.1%,3,1.7%,1,0.6%
York,112672203,Eastern York SD,199,123,61.8%,103,51.8%,140,70.4%,17,8.5%,20,10.1%
Northampton,120483302,Easton Area SD,639,525,82.2%,516,80.8%,539,84.4%,14,2.2%,9,1.4%
Allegheny,103023153,Elizabeth Forward SD,222,154,69.4%,143,64.4%,158,71.2%,4,1.8%,11,5.0%
Lancaster,113362403,Elizabethtown Area SD,305,206,67.5%,199,65.2%,213,69.8%,7,2.3%,7,2.3%
Susquehanna,119582503,Elk Lake SD,80,48,60.0%,48,60.0%,52,65.0%,4,5.0%,0,0.0%
Lawrence,104372003,Ellwood City Area SD,118,86,72.9%,86,72.9%,101,85.6%,15,12.7%,0,0.0%
Lancaster,113362603,Ephrata Area SD,313,190,60.7%,181,57.8%,212,67.7%,22,7.0%,9,2.9%
Erie,105252602,Erie City SD,787,577,73.3%,541,68.7%,582,74.0%,5,0.6%,36,4.6%
Bedford,108053003,Everett Area SD,118,52,44.1%,52,44.1%,56,47.5%,4,3.4%,0,0.0%
Berks,114062003,Exeter Township SD,336,253,75.3%,246,73.2%,267,79.5%,14,4.2%,7,2.1%
Adams,112013054,Fairfield Area SD,96,63,65.6%,59,61.5%,70,72.9%,7,7.3%,4,4.2%
Erie,105253303,Fairview SD,148,114,77.0%,113,76.4%,122,82.4%,8,5.4%,1,0.7%
Franklin,112282004,Fannett-Metal SD,52,24,46.2%,24,46.2%,28,53.8%,4,7.7%,0,0.0%
Mercer,104432503,Farrell Area SD,60,42,70.0%,35,58.3%,45,75.0%,3,5.0%,7,11.7%
Cambria,108112003,Ferndale Area SD,64,44,68.8%,44,68.8%,47,73.4%,3,4.7%,0,0.0%
Berks,114062503,Fleetwood Area SD,200,151,75.5%,138,69.0%,151,75.5%,0,0.0%,13,6.5%
Fulton,111292304,Forbes Road SD,36,21,58.3%,21,58.3%,21,58.3%,0,0.0%,0,0.0%
Forest,106272003,Forest Area SD,57,36,63.2%,33,57.9%,37,64.9%,1,1.8%,3,5.3%
Susquehanna,119583003,Forest City Regional SD,69,45,65.2%,44,63.8%,48,69.6%,3,4.3%,1,1.4%
Cambria,108112203,Forest Hills SD,175,121,69.1%,116,66.3%,129,73.7%,8,4.6%,5,2.9%
Washington,101632403,Fort Cherry SD,86,61,70.9%,60,69.8%,61,70.9%,0,0.0%,1,1.2%
Erie,105253553,Fort LeBoeuf SD,183,132,72.1%,125,68.3%,144,78.7%,12,6.6%,7,3.8%
Allegheny,103023912,Fox Chapel Area SD,370,328,88.6%,322,87.0%,333,90.0%,5,1.4%,6,1.6%
Venango,106612203,Franklin Area SD,155,88,56.8%,79,51.0%,96,61.9%,8,5.2%,9,5.8%
Westmoreland,107652603,Franklin Regional SD,307,266,86.6%,260,84.7%,267,87.0%,1,0.3%,6,2.0%
Fayette,101262903,Frazier SD,78,49,62.8%,48,61.5%,49,62.8%,0,0.0%,1,1.3%
Beaver,127042853,Freedom Area SD,124,91,73.4%,91,73.4%,93,75.0%,2,1.6%,0,0.0%
Armstrong,128033053,Freeport Area SD,140,108,77.1%,105,75.0%,114,81.4%,6,4.3%,3,2.1%
Potter,109532804,Galeton Area SD,19,12,63.2%,8,42.1%,13,68.4%,1,5.3%,4,21.1%
Delaware,125234103,Garnet Valley SD,377,344,91.2%,337,89.4%,346,91.8%,2,0.5%,7,1.9%
Allegheny,103024102,Gateway SD,343,304,88.6%,293,85.4%,313,91.3%,9,2.6%,11,3.2%
Erie,105253903,General McLane SD,176,131,74.4%,123,69.9%,131,74.4%,0,0.0%,8,4.5%
Adams,112013753,Gettysburg Area SD,236,156,66.1%,137,58.1%,163,69.1%,7,3.0%,19,8.1%
Erie,105254053,Girard SD,144,91,63.2%,74,51.4%,92,63.9%,1,0.7%,17,11.8%
Clearfield,110173003,Glendale SD,56,38,67.9%,27,48.2%,41,73.2%,3,5.4%,11,19.6%
Berks,114063003,Governor Mifflin SD,300,204,68.0%,200,66.7%,214,71.3%,10,3.3%,4,1.3%
Chester,124153503,Great Valley SD,302,269,89.1%,269,89.1%,270,89.4%,1,0.3%,0,0.0%
Cambria,108112502,Greater Johnstown SD,226,152,67.3%,130,57.5%,152,67.3%,0,0.0%,22,9.7%
Westmoreland,107653102,Greater Latrobe SD,360,304,84.4%,300,83.3%,307,85.3%,3,0.8%,4,1.1%
Luzerne,118402603,Greater Nanticoke Area SD,160,111,69.4%,111,69.4%,112,70.0%,1,0.6%,0,0.0%
Franklin,112283003,Greencastle-Antrim SD,197,130,66.0%,121,61.4%,133,67.5%,3,1.5%,9,4.6%
Westmoreland,107653203,Greensburg Salem SD,238,165,69.3%,154,64.7%,165,69.3%,0,0.0%,11,4.6%
Mercer,104432803,Greenville Area SD,124,87,70.2%,83,66.9%,89,71.8%,2,1.6%,4,3.2%
Perry,115503004,Greenwood SD,53,42,79.2%,42,79.2%,42,79.2%,0,0.0%,0,0.0%
Mercer,104432903,Grove City Area SD,228,171,75.0%,155,68.0%,177,77.6%,6,2.6%,16,7.0%
Dauphin,115222504,Halifax Area SD,90,70,77.8%,62,68.9%,72,80.0%,2,2.2%,8,8.9%
Berks,114063503,Hamburg Area SD,193,141,73.1%,123,63.7%,147,76.2%,6,3.1%,18,9.3%
Allegheny,103024603,Hampton Township SD,252,231,91.7%,227,90.1%,234,92.9%,3,1.2%,4,1.6%
Luzerne,118403003,Hanover Area SD,149,113,75.8%,112,75.2%,118,79.2%,5,3.4%,1,0.7%
York,112672803,Hanover Public SD,116,44,37.9%,44,37.9%,45,38.8%,1,0.9%,0,0.0%
Erie,105254353,Harbor Creek SD,178,113,63.5%,113,63.5%,128,71.9%,15,8.4%,0,0.0%
Clearfield,110173504,Harmony Area SD,33,16,48.5%,6,18.2%,19,57.6%,3,9.1%,10,30.3%
Dauphin,115222752,Harrisburg City SD,326,294,90.2%,292,89.6%,295,90.5%,1,0.3%,2,0.6%
Montgomery,123463603,Hatboro-Horsham SD,414,350,84.5%,349,84.3%,352,85.0%,2,0.5%,1,0.2%
Delaware,125234502,Haverford Township SD,469,401,85.5%,392,83.6%,406,86.6%,5,1.1%,9,1.9%
Luzerne,118403302,Hazleton Area SD,715,476,66.6%,454,63.5%,492,68.8%,16,2.2%,22,3.1%
Lancaster,113363103,Hempfield  SD,558,444,79.6%,422,75.6%,456,81.7%,12,2.2%,22,3.9%
Westmoreland,107653802,Hempfield Area SD,445,386,86.7%,378,84.9%,389,87.4%,3,0.7%,8,1.8%
Mercer,104433303,Hermitage SD,179,137,76.5%,128,71.5%,141,78.8%,4,2.2%,9,5.0%
Allegheny,103024753,Highlands SD,196,125,63.8%,125,63.8%,149,76.0%,24,12.2%,0,0.0%
Blair,108073503,Hollidaysburg Area SD,264,170,64.4%,170,64.4%,180,68.2%,10,3.8%,0,0.0%
Indiana,128323303,Homer-Center SD,69,51,73.9%,51,73.9%,51,73.9%,0,0.0%,0,0.0%
Beaver,127044103,Hopewell Area SD,206,136,66.0%,128,62.1%,141,68.4%,5,2.4%,8,3.9%
Huntingdon,111312503,Huntingdon Area SD,162,95,58.6%,91,56.2%,103,63.6%,8,4.9%,4,2.5%
Indiana,128323703,Indiana Area SD,190,156,82.1%,155,81.6%,160,84.2%,4,2.1%,1,0.5%
Delaware,125235103,Interboro SD,316,255,80.7%,246,77.8%,269,85.1%,14,4.4%,9,2.8%
Erie,105256553,Iroquois SD,93,59,63.4%,56,60.2%,67,72.0%,8,8.6%,3,3.2%
Mercer,104433604,Jamestown Area SD,45,31,68.9%,25,55.6%,31,68.9%,0,0.0%,6,13.3%
Westmoreland,107654103,Jeannette City SD,83,57,68.7%,54,65.1%,59,71.1%,2,2.4%,3,3.6%
Greene,101303503,Jefferson-Morgan SD,45,30,66.7%,29,64.4%,33,73.3%,3,6.7%,1,2.2%
Montgomery,123463803,Jenkintown SD,48,38,79.2%,38,79.2%,38,79.2%,0,0.0%,0,0.0%
Lycoming,117414003,Jersey Shore Area SD,184,108,58.7%,104,56.5%,108,58.7%,0,0.0%,4,2.2%
Carbon,121135003,Jim Thorpe Area SD,125,98,78.4%,91,72.8%,103,82.4%,5,4.0%,7,5.6%
Elk,109243503,Johnsonburg Area SD,48,32,66.7%,30,62.5%,33,68.8%,1,2.1%,2,4.2%
Juniata,111343603,Juniata County SD,238,122,51.3%,101,42.4%,123,51.7%,1,0.4%,21,8.8%
Huntingdon,111312804,Juniata Valley SD,70,37,52.9%,35,50.0%,40,57.1%,3,4.3%,2,2.9%
McKean,109422303,Kane Area SD,65,48,73.8%,48,73.8%,48,73.8%,0,0.0%,0,0.0%
Butler,104103603,Karns City Area SD,122,89,73.0%,80,65.6%,91,74.6%,2,1.6%,9,7.4%
Chester,124154003,Kennett Consolidated SD,308,226,73.4%,226,73.4%,226,73.4%,0,0.0%,0,0.0%
Clarion,106166503,Keystone  SD,89,45,50.6%,42,47.2%,46,51.7%,1,1.1%,3,3.4%
Clinton,110183602,Keystone Central SD,354,182,51.4%,160,45.2%,189,53.4%,7,2.0%,22,6.2%
Allegheny,103025002,Keystone Oaks SD,170,124,72.9%,120,70.6%,127,74.7%,3,1.8%,4,2.4%
Westmoreland,107654403,Kiski Area SD,299,250,83.6%,231,77.3%,252,84.3%,2,0.7%,19,6.4%
Berks,114064003,Kutztown Area SD,111,80,72.1%,77,69.4%,80,72.1%,0,0.0%,3,2.7%
Wyoming,119665003,Lackawanna Trail SD,101,66,65.3%,66,65.3%,68,67.3%,2,2.0%,0,0.0%
Lackawanna,119354603,Lakeland SD,134,110,82.1%,103,76.9%,113,84.3%,3,2.2%,7,5.2%
Luzerne,118403903,Lake-Lehman SD,161,128,79.5%,126,78.3%,130,80.7%,2,1.2%,2,1.2%
Mercer,104433903,Lakeview SD,94,56,59.6%,54,57.4%,70,74.5%,14,14.9%,2,2.1%
Lancaster,113363603,Lampeter-Strasburg SD,259,208,80.3%,199,76.8%,212,81.9%,4,1.5%,9,3.5%
Lancaster,113364002,Lancaster SD,626,420,67.1%,401,64.1%,443,70.8%,23,3.7%,19,3.0%
Fayette,101264003,Laurel Highlands SD,244,169,69.3%,161,66.0%,179,73.4%,10,4.1%,8,3.3%
Lawrence,104374003,Laurel SD,118,99,83.9%,76,64.4%,100,84.7%,1,0.8%,23,19.5%
Lebanon,113384603,Lebanon SD,191,118,61.8%,118,61.8%,118,61.8%,0,0.0%,0,0.0%
Armstrong,128034503,Leechburg Area SD,48,33,68.8%,33,68.8%,42,87.5%,9,18.8%,0,0.0%
Carbon,121135503,Lehighton Area SD,186,149,80.1%,149,80.1%,149,80.1%,0,0.0%,0,0.0%
Union,116604003,Lewisburg Area SD,145,119,82.1%,118,81.4%,121,83.4%,2,1.4%,1,0.7%
Westmoreland,107654903,Ligonier Valley SD,159,111,69.8%,107,67.3%,129,81.1%,18,11.3%,4,2.5%
Northumberland,116493503,Line Mountain SD,101,61,60.4%,55,54.5%,69,68.3%,8,7.9%,6,5.9%
Adams,112015203,Littlestown Area SD,162,93,57.4%,90,55.6%,95,58.6%,2,1.2%,3,1.9%
Dauphin,115224003,Lower Dauphin SD,305,199,65.2%,199,65.2%,199,65.2%,0,0.0%,0,0.0%
Montgomery,123464502,Lower Merion SD,540,496,91.9%,494,91.5%,503,93.1%,7,1.3%,2,0.4%
Montgomery,123464603,Lower Moreland Township SD,173,161,93.1%,161,93.1%,164,94.8%,3,1.7%,0,0.0%
Lycoming,117414203,Loyalsock Township SD,111,92,82.9%,92,82.9%,92,82.9%,0,0.0%,0,0.0%
Schuylkill,129544503,Mahanoy Area SD,76,51,67.1%,49,64.5%,52,68.4%,1,1.3%,2,2.6%
Lancaster,113364403,Manheim Central SD,464,305,65.7%,288,62.1%,310,66.8%,5,1.1%,17,3.7%
Lancaster,113364503,Manheim Township SD,469,348,74.2%,348,74.2%,348,74.2%,0,0.0%,0,0.0%
Indiana,128325203,Marion Center Area SD,116,74,63.8%,64,55.2%,81,69.8%,7,6.0%,10,8.6%
Delaware,125235502,Marple Newtown SD,292,252,86.3%,250,85.6%,260,89.0%,8,2.7%,2,0.7%
Butler,104105003,Mars Area SD,214,203,94.9%,199,93.0%,204,95.3%,1,0.5%,4,1.9%
Washington,101633903,McGuffey SD,155,113,72.9%,110,71.0%,113,72.9%,0,0.0%,3,1.9%
Allegheny,103026002,McKeesport Area SD,271,196,72.3%,176,64.9%,200,73.8%,4,1.5%,20,7.4%
Cumberland,115216503,Mechanicsburg Area SD,266,215,80.8%,210,78.9%,223,83.8%,8,3.0%,5,1.9%
Mercer,104435003,Mercer Area SD,108,69,63.9%,66,61.1%,70,64.8%,1,0.9%,3,2.8%
Montgomery,123465303,Methacton SD,441,405,91.8%,401,90.9%,405,91.8%,0,0.0%,4,0.9%
Somerset,108565203,Meyersdale Area SD,64,37,57.8%,37,57.8%,45,70.3%,8,12.5%,0,0.0%
Lackawanna,119355503,Mid Valley SD,117,69,59.0%,66,56.4%,74,63.2%,5,4.3%,3,2.6%
Dauphin,115226003,Middletown Area SD,159,126,79.2%,123,77.4%,132,83.0%,6,3.8%,3,1.9%
Snyder,116555003,Midd-West SD,145,71,49.0%,68,46.9%,71,49.0%,0,0.0%,3,2.1%
Mifflin,111444602,Mifflin County SD,382,204,53.4%,168,44.0%,218,57.1%,14,3.7%,36,9.4%
Union,116605003,Mifflinburg Area SD,178,109,61.2%,109,61.2%,111,62.4%,2,1.1%,0,0.0%
Erie,105257602,Millcreek Township SD,571,413,72.3%,386,67.6%,429,75.1%,16,2.8%,27,4.7%
Dauphin,115226103,Millersburg Area SD,68,53,77.9%,51,75.0%,54,79.4%,1,1.5%,2,2.9%
Columbia,116195004,Millville Area SD,50,38,76.0%,37,74.0%,38,76.0%,0,0.0%,1,2.0%
Northumberland,116495003,Milton Area SD,156,91,58.3%,81,51.9%,93,59.6%,2,1.3%,10,6.4%
Schuylkill,129544703,Minersville Area SD,87,61,70.1%,57,65.5%,61,70.1%,0,0.0%,4,4.6%
Lawrence,104375003,Mohawk Area SD,107,73,68.2%,69,64.5%,77,72.0%,4,3.7%,4,3.7%
Westmoreland,107655803,Monessen City SD,74,55,74.3%,55,74.3%,55,74.3%,0,0.0%,0,0.0%
Butler,104105353,Moniteau SD,107,58,54.2%,56,52.3%,69,64.5%,11,10.3%,2,1.9%
Lycoming,117415004,Montgomery Area SD,57,29,50.9%,26,45.6%,29,50.9%,0,0.0%,3,5.3%
Allegheny,103026303,Montour SD,252,212,84.1%,211,83.7%,213,84.5%,1,0.4%,1,0.4%
Lycoming,117415103,Montoursville Area SD,146,104,71.2%,104,71.2%,109,74.7%,5,3.4%,0,0.0%
Susquehanna,119584503,Montrose Area SD,143,86,60.1%,83,58.0%,91,63.6%,5,3.5%,3,2.1%
Allegheny,103026343,Moon Area SD,283,235,83.0%,220,77.7%,236,83.4%,1,0.4%,15,5.3%
Bucks,122097203,Morrisville Borough SD,62,38,61.3%,35,56.5%,39,62.9%,1,1.6%,3,4.8%
Clearfield,110175003,Moshannon Valley SD,69,36,52.2%,34,49.3%,40,58.0%,4,5.8%,2,2.9%
Northumberland,116495103,Mount Carmel Area SD,108,71,65.7%,68,63.0%,73,67.6%,2,1.9%,3,2.8%
Westmoreland,107655903,Mount Pleasant Area SD,145,104,71.7%,100,69.0%,105,72.4%,1,0.7%,4,2.8%
Huntingdon,111316003,Mount Union Area SD,107,57,53.3%,51,47.7%,62,57.9%,5,4.7%,6,5.6%
Susquehanna,119584603,Mountain View SD,98,58,59.2%,54,55.1%,61,62.2%,3,3.1%,4,4.1%
Allegheny,103026402,Mt Lebanon SD,433,411,94.9%,408,94.2%,411,94.9%,0,0.0%,3,0.7%
Berks,114065503,Muhlenberg SD,295,226,76.6%,215,72.9%,242,82.0%,16,5.4%,11,3.7%
Lycoming,117415303,Muncy SD,65,49,75.4%,46,70.8%,51,78.5%,2,3.1%,3,4.6%
Northampton,120484803,Nazareth Area SD,404,335,82.9%,333,82.4%,345,85.4%,10,2.5%,2,0.5%
Bucks,122097502,Neshaminy SD,700,616,88.0%,616,88.0%,632,90.3%,16,2.3%,0,0.0%
Lawrence,104375203,Neshannock Township SD,109,95,87.2%,91,83.5%,96,88.1%,1,0.9%,4,3.7%
Beaver,127045653,New Brighton Area SD,134,99,73.9%,87,64.9%,107,79.9%,8,6.0%,12,9.0%
Lawrence,104375302,New Castle Area SD,200,131,65.5%,122,61.0%,137,68.5%,6,3.0%,9,4.5%
Bucks,122097604,New Hope-Solebury SD,117,110,94.0%,110,94.0%,111,94.9%,1,0.9%,0,0.0%
Westmoreland,107656303,New Kensington-Arnold SD,166,140,84.3%,139,83.7%,140,84.3%,0,0.0%,1,0.6%
Perry,115504003,Newport SD,82,47,57.3%,44,53.7%,47,57.3%,0,0.0%,3,3.7%
Montgomery,123465602,Norristown Area SD,440,367,83.4%,366,83.2%,367,83.4%,0,0.0%,1,0.2%
Allegheny,103026852,North Allegheny SD,649,586,90.3%,581,89.5%,588,90.6%,2,0.3%,5,0.8%
Clarion,106167504,North Clarion County SD,51,31,60.8%,31,60.8%,31,60.8%,0,0.0%,0,0.0%
Erie,105258303,North East SD,145,110,75.9%,98,67.6%,116,80.0%,6,4.1%,12,8.3%
Allegheny,103026902,North Hills SD,364,297,81.6%,296,81.3%,304,83.5%,7,1.9%,1,0.3%
Montgomery,123465702,North Penn SD,978,863,88.2%,860,87.9%,877,89.7%,14,1.4%,3,0.3%
Lackawanna,119356503,North Pocono SD,242,180,74.4%,171,70.7%,192,79.3%,12,5.0%,9,3.7%
Schuylkill,129545003,North Schuylkill SD,142,107,75.4%,105,73.9%,107,75.4%,0,0.0%,2,1.4%
Somerset,108565503,North Star SD,93,56,60.2%,56,60.2%,56,60.2%,0,0.0%,0,0.0%
Northampton,120484903,Northampton Area SD,428,355,82.9%,343,80.1%,356,83.2%,1,0.2%,12,2.8%
Bradford,117083004,Northeast Bradford SD,59,34,57.6%,34,57.6%,39,66.1%,5,8.5%,0,0.0%
York,112674403,Northeastern York SD,237,162,68.4%,156,65.8%,175,73.8%,13,5.5%,6,2.5%
Bedford,108056004,Northern Bedford County SD,79,47,59.5%,45,57.0%,55,69.6%,8,10.1%,2,2.5%
Cambria,108114503,Northern Cambria SD,89,53,59.6%,43,48.3%,56,62.9%,3,3.4%,10,11.2%
Lebanon,113385003,Northern Lebanon SD,194,130,67.0%,116,59.8%,135,69.6%,5,2.6%,14,7.2%
Lehigh,121394503,Northern Lehigh SD,143,114,79.7%,113,79.0%,118,82.5%,4,2.8%,1,0.7%
Potter,109535504,Northern Potter SD,48,31,64.6%,18,37.5%,31,64.6%,0,0.0%,13,27.1%
Tioga,117596003,Northern Tioga SD,171,107,62.6%,97,56.7%,108,63.2%,1,0.6%,10,5.8%
York,115674603,Northern York County SD,234,167,71.4%,158,67.5%,171,73.1%,4,1.7%,9,3.8%
Allegheny,103026873,Northgate SD,93,80,86.0%,65,69.9%,81,87.1%,1,1.1%,15,16.1%
Luzerne,118406003,Northwest Area SD,76,52,68.4%,52,68.4%,56,73.7%,4,5.3%,0,0.0%
Erie,105258503,Northwestern  SD,135,93,68.9%,64,47.4%,94,69.6%,1,0.7%,29,21.5%
Lehigh,121394603,Northwestern Lehigh SD,205,159,77.6%,158,77.1%,162,79.0%,3,1.5%,1,0.5%
Westmoreland,107656502,Norwin SD,398,341,85.7%,323,81.2%,341,85.7%,0,0.0%,18,4.5%
Chester,124156503,Octorara Area SD,203,138,68.0%,116,57.1%,140,69.0%,2,1.0%,22,10.8%
Venango,106616203,Oil City Area SD,183,93,50.8%,82,44.8%,99,54.1%,6,3.3%,11,6.0%
Lackawanna,119356603,Old Forge SD,82,64,78.0%,64,78.0%,72,87.8%,8,9.8%,0,0.0%
Berks,114066503,Oley Valley SD,155,114,73.5%,113,72.9%,118,76.1%,4,2.6%,1,0.6%
Potter,109537504,Oswayo Valley SD,34,21,61.8%,21,61.8%,23,67.6%,2,5.9%,0,0.0%
McKean,109426003,Otto-Eldred SD,47,28,59.6%,19,40.4%,30,63.8%,2,4.3%,9,19.1%
Chester,124156603,Owen J Roberts SD,369,312,84.6%,304,82.4%,315,85.4%,3,0.8%,8,2.2%
Chester,124156703,Oxford Area SD,274,204,74.5%,195,71.2%,211,77.0%,7,2.6%,9,3.3%
Bucks,122098003,Palisades SD,155,120,77.4%,120,77.4%,120,77.4%,0,0.0%,0,0.0%
Carbon,121136503,Palmerton Area SD,146,109,74.7%,105,71.9%,118,80.8%,9,6.2%,4,2.7%
Lebanon,113385303,Palmyra Area SD,213,117,54.9%,115,54.0%,117,54.9%,0,0.0%,2,0.9%
Carbon,121136603,Panther Valley SD,88,68,77.3%,66,75.0%,68,77.3%,0,0.0%,2,2.3%
Lehigh,121395103,Parkland SD,744,638,85.8%,638,85.8%,649,87.2%,11,1.5%,0,0.0%
Northampton,120485603,Pen Argyl Area SD,160,123,76.9%,123,76.9%,128,80.0%,5,3.1%,0,0.0%
Cambria,108116003,Penn Cambria SD,115,74,64.3%,70,60.9%,79,68.7%,5,4.3%,4,3.5%
Allegheny,103027352,Penn Hills SD,352,290,82.4%,284,80.7%,296,84.1%,6,1.7%,6,1.7%
Lancaster,113365203,Penn Manor SD,458,303,66.2%,275,60.0%,306,66.8%,3,0.7%,28,6.1%
Crawford,105204703,Penncrest SD,248,158,63.7%,150,60.5%,167,67.3%,9,3.6%,8,3.2%
Delaware,125236903,Penn-Delco SD,293,248,84.6%,245,83.6%,260,88.7%,12,4.1%,3,1.0%
Bucks,122098103,Pennridge SD,560,466,83.2%,466,83.2%,473,84.5%,7,1.3%,0,0.0%
Indiana,128326303,Penns Manor Area SD,53,38,71.7%,36,67.9%,41,77.4%,3,5.7%,2,3.8%
Centre,110147003,Penns Valley Area SD,97,63,64.9%,52,53.6%,68,70.1%,5,5.2%,11,11.3%
Bucks,122098202,Pennsbury SD,754,630,83.6%,628,83.3%,645,85.5%,15,2.0%,2,0.3%
Westmoreland,107657103,Penn-Trafford SD,398,347,87.2%,339,85.2%,350,87.9%,3,0.8%,8,2.0%
Lancaster,113365303,Pequea Valley SD,153,84,54.9%,79,51.6%,94,61.4%,10,6.5%,5,3.3%
Montgomery,123466103,Perkiomen Valley SD,392,344,87.8%,342,87.2%,351,89.5%,7,1.8%,2,0.5%
Washington,101636503,Peters Township SD,350,324,92.6%,322,92.0%,332,94.9%,8,2.3%,2,0.6%
Philadelphia,126515001,Philadelphia City SD,9351,5821,62.3%,5654,60.5%,6203,66.3%,382,4.1%,167,1.8%
Clearfield,110177003,Philipsburg-Osceola Area SD,136,85,62.5%,75,55.1%,85,62.5%,0,0.0%,10,7.4%
Chester,124157203,Phoenixville Area SD,267,214,80.1%,211,79.0%,219,82.0%,5,1.9%,3,1.1%
Schuylkill,129546003,Pine Grove Area SD,134,70,52.2%,62,46.3%,80,59.7%,10,7.5%,8,6.0%
Allegheny,103021003,Pine-Richland SD,372,324,87.1%,324,87.1%,331,89.0%,7,1.9%,0,0.0%
Allegheny,102027451,Pittsburgh SD,1603,0,0.0%,0,0.0%,0,0.0%,0,0.0%,0,0.0%
Luzerne,118406602,Pittston Area SD,301,239,79.4%,229,76.1%,245,81.4%,6,2.0%,10,3.3%
Monroe,120455203,Pleasant Valley SD,487,368,75.6%,360,73.9%,373,76.6%,5,1.0%,8,1.6%
Allegheny,103027503,Plum Borough SD,322,247,76.7%,243,75.5%,254,78.9%,7,2.2%,4,1.2%
Monroe,120455403,Pocono Mountain SD,795,548,68.9%,538,67.7%,558,70.2%,10,1.3%,10,1.3%
McKean,109426303,Port Allegany SD,90,57,63.3%,57,63.3%,61,67.8%,4,4.4%,0,0.0%
Cambria,108116303,Portage Area SD,66,34,51.5%,31,47.0%,37,56.1%,3,4.5%,3,4.5%
Montgomery,123466303,Pottsgrove SD,306,213,69.6%,209,68.3%,232,75.8%,19,6.2%,4,1.3%
Montgomery,123466403,Pottstown SD,173,118,68.2%,110,63.6%,135,78.0%,17,9.8%,8,4.6%
Schuylkill,129546103,Pottsville Area SD,270,163,60.4%,117,43.3%,164,60.7%,1,0.4%,46,17.0%
Jefferson,106338003,Punxsutawney Area SD,164,110,67.1%,94,57.3%,119,72.6%,9,5.5%,16,9.8%
Indiana,128327303,Purchase Line SD,63,29,46.0%,24,38.1%,34,54.0%,5,7.9%,5,7.9%
Allegheny,103027753,Quaker Valley SD,182,155,85.2%,155,85.2%,159,87.4%,4,2.2%,0,0.0%
Bucks,122098403,Quakertown Community SD,385,325,84.4%,320,83.1%,330,85.7%,5,1.3%,5,1.3%
Delaware,125237603,Radnor Township SD,296,273,92.2%,273,92.2%,273,92.2%,0,0.0%,0,0.0%
Berks,114067002,Reading SD,780,486,62.3%,470,60.3%,494,63.3%,8,1.0%,16,2.1%
York,112675503,Red Lion Area SD,416,274,65.9%,246,59.1%,287,69.0%,13,3.1%,28,6.7%
Clarion,106168003,Redbank Valley SD,98,58,59.2%,58,59.2%,62,63.3%,4,4.1%,0,0.0%
Mercer,104435303,Reynolds SD,106,73,68.9%,55,51.9%,82,77.4%,9,8.5%,18,17.0%
Cambria,108116503,Richland SD,127,98,77.2%,96,75.6%,102,80.3%,4,3.1%,2,1.6%
Elk,109246003,Ridgway Area SD,96,56,58.3%,42,43.8%,56,58.3%,0,0.0%,14,14.6%
Delaware,125237702,Ridley SD,463,374,80.8%,360,77.8%,385,83.2%,11,2.4%,14,3.0%
Washington,101637002,Ringgold SD,250,206,82.4%,199,79.6%,211,84.4%,5,2.0%,7,2.8%
Beaver,127045853,Riverside Beaver County SD,139,97,69.8%,94,67.6%,97,69.8%,0,0.0%,3,2.2%
Lackawanna,119357003,Riverside SD,123,87,70.7%,85,69.1%,93,75.6%,6,4.9%,2,1.6%
Allegheny,103028203,Riverview SD,95,79,83.2%,79,83.2%,81,85.3%,2,2.1%,0,0.0%
Beaver,127046903,Rochester Area SD,65,29,44.6%,29,44.6%,38,58.5%,9,13.8%,0,0.0%
Somerset,108566303,Rockwood Area SD,52,31,59.6%,31,59.6%,31,59.6%,0,0.0%,0,0.0%
Delaware,125237903,Rose Tree Media SD,329,294,89.4%,292,88.8%,302,91.8%,8,2.4%,2,0.6%
Elk,109248003,Saint Marys Area SD,171,109,63.7%,103,60.2%,120,70.2%,11,6.4%,6,3.5%
Lehigh,121395603,Salisbury Township SD,125,106,84.8%,106,84.8%,108,86.4%,2,1.6%,0,0.0%
Somerset,108567004,Salisbury-Elk Lick SD,30,15,50.0%,14,46.7%,17,56.7%,2,6.7%,1,3.3%
Northampton,120486003,Saucon Valley SD,180,157,87.2%,156,86.7%,157,87.2%,0,0.0%,1,0.6%
Bradford,117086003,Sayre Area SD,72,55,76.4%,55,76.4%,57,79.2%,2,2.8%,0,0.0%
Schuylkill,129547303,Schuylkill Haven Area SD,95,62,65.3%,60,63.2%,70,73.7%,8,8.4%,2,2.1%
Berks,114067503,Schuylkill Valley SD,148,106,71.6%,96,64.9%,110,74.3%,4,2.7%,10,6.8%
Lackawanna,119357402,Scranton SD,601,431,71.7%,424,70.5%,464,77.2%,33,5.5%,7,1.2%
Snyder,116557103,Selinsgrove Area SD,201,141,70.1%,139,69.2%,147,73.1%,6,3.0%,2,1.0%
Butler,104107903,Seneca Valley SD,534,457,85.6%,444,83.1%,467,87.5%,10,1.9%,13,2.4%
Somerset,108567204,Shade-Central City SD,48,24,50.0%,24,50.0%,26,54.2%,2,4.2%,0,0.0%
Allegheny,103028302,Shaler Area SD,477,387,81.1%,378,79.2%,395,82.8%,8,1.7%,9,1.9%
Northumberland,116496503,Shamokin Area SD,205,107,52.2%,103,50.2%,107,52.2%,0,0.0%,4,2.0%
Somerset,108567404,Shanksville-Stonycreek SD,31,18,58.1%,17,54.8%,18,58.1%,0,0.0%,1,3.2%
Mercer,104435603,Sharon City SD,133,97,72.9%,83,62.4%,97,72.9%,0,0.0%,14,10.5%
Mercer,104435703,Sharpsville Area SD,96,77,80.2%,77,80.2%,77,80.2%,0,0.0%,0,0.0%
Schuylkill,129547203,Shenandoah Valley SD,82,54,65.9%,54,65.9%,58,70.7%,4,4.9%,0,0.0%
Lawrence,104376203,Shenango Area SD,90,68,75.6%,66,73.3%,74,82.2%,6,6.7%,2,2.2%
Northumberland,116496603,Shikellamy SD,193,107,55.4%,101,52.3%,108,56.0%,1,0.5%,6,3.1%
Cumberland,115218003,Shippensburg Area SD,290,184,63.4%,184,63.4%,191,65.9%,7,2.4%,0,0.0%
Butler,104107503,Slippery Rock Area SD,189,136,72.0%,136,72.0%,143,75.7%,7,3.7%,0,0.0%
McKean,109427503,Smethport Area SD,62,40,64.5%,33,53.2%,44,71.0%,4,6.5%,7,11.3%
Lancaster,113367003,Solanco SD,274,164,59.9%,153,55.8%,168,61.3%,4,1.5%,11,4.0%
Somerset,108567703,Somerset Area SD,164,102,62.2%,102,62.2%,107,65.2%,5,3.0%,0,0.0%
Montgomery,123467103,Souderton Area SD,567,441,77.8%,441,77.8%,442,78.0%,1,0.2%,0,0.0%
Allegheny,103028653,South Allegheny SD,150,97,64.7%,89,59.3%,100,66.7%,3,2.0%,8,5.3%
Butler,104107803,South Butler County SD,222,174,78.4%,172,77.5%,180,81.1%,6,2.7%,2,0.9%
York,112676203,South Eastern SD,215,160,74.4%,142,66.0%,160,74.4%,0,0.0%,18,8.4%
Allegheny,103028703,South Fayette Township SD,147,125,85.0%,121,82.3%,127,86.4%,2,1.4%,4,2.7%
Cumberland,115218303,South Middleton SD,161,123,76.4%,121,75.2%,125,77.6%,2,1.2%,2,1.2%
Allegheny,103028753,South Park SD,183,156,85.2%,156,85.2%,156,85.2%,0,0.0%,0,0.0%
Beaver,127047404,South Side Area SD,105,83,79.0%,83,79.0%,83,79.0%,0,0.0%,0,0.0%
York,112676403,South Western SD,325,230,70.8%,216,66.5%,248,76.3%,18,5.5%,14,4.3%
Lycoming,117416103,South Williamsport Area SD,92,70,76.1%,69,75.0%,71,77.2%,1,1.1%,1,1.1%
Delaware,125238402,Southeast Delco SD,254,181,71.3%,178,70.1%,188,74.0%,7,2.8%,3,1.2%
Greene,101306503,Southeastern Greene SD,49,25,51.0%,24,49.0%,27,55.1%,2,4.1%,1,2.0%
Columbia,116197503,Southern Columbia Area SD,94,75,79.8%,75,79.8%,76,80.9%,1,1.1%,0,0.0%
Fulton,111297504,Southern Fulton SD,67,28,41.8%,27,40.3%,31,46.3%,3,4.5%,1,1.5%
Huntingdon,111317503,Southern Huntingdon County SD,92,55,59.8%,52,56.5%,56,60.9%,1,1.1%,3,3.3%
Lehigh,121395703,Southern Lehigh SD,244,216,88.5%,215,88.1%,221,90.6%,5,2.0%,1,0.4%
Tioga,117597003,Southern Tioga SD,133,69,51.9%,65,48.9%,73,54.9%,4,3.0%,4,3.0%
York,112676503,Southern York County SD,251,170,67.7%,162,64.5%,190,75.7%,20,8.0%,8,3.2%
Westmoreland,107657503,Southmoreland SD,167,120,71.9%,120,71.9%,132,79.0%,12,7.2%,0,0.0%
Blair,108077503,Spring Cove SD,130,79,60.8%,75,57.7%,83,63.8%,4,3.1%,4,3.1%
York,112676703,Spring Grove Area SD,276,174,63.0%,163,59.1%,179,64.9%,5,1.8%,11,4.0%
Delaware,125238502,Springfield SD,303,275,90.8%,275,90.8%,279,92.1%,4,1.3%,0,0.0%
Montgomery,123467203,Springfield Township SD,164,146,89.0%,146,89.0%,148,90.2%,2,1.2%,0,0.0%
Montgomery,123467303,Spring-Ford Area SD,526,448,85.2%,445,84.6%,457,86.9%,9,1.7%,3,0.6%
Centre,110148002,State College Area SD,579,505,87.2%,488,84.3%,507,87.6%,2,0.3%,17,2.9%
Allegheny,103028833,Steel Valley SD,168,96,57.1%,90,53.6%,105,62.5%,9,5.4%,6,3.6%
Dauphin,115228003,Steelton-Highspire SD,81,48,59.3%,45,55.6%,57,70.4%,9,11.1%,3,3.7%
Allegheny,103028853,Sto-Rox SD,98,64,65.3%,64,65.3%,65,66.3%,1,1.0%,0,0.0%
Monroe,120456003,Stroudsburg Area SD,473,350,74.0%,347,73.4%,352,74.4%,2,0.4%,3,0.6%
Sullivan,117576303,Sullivan County SD,56,33,58.9%,33,58.9%,34,60.7%,1,1.8%,0,0.0%
Susquehanna,119586503,Susquehanna Community SD,62,36,58.1%,33,53.2%,36,58.1%,0,0.0%,3,4.8%
Dauphin,115228303,Susquehanna Township SD,245,205,83.7%,203,82.9%,211,86.1%,6,2.4%,2,0.8%
Perry,115506003,Susquenita SD,145,96,66.2%,94,64.8%,96,66.2%,0,0.0%,2,1.4%
Schuylkill,129547603,Tamaqua Area SD,146,131,89.7%,128,87.7%,133,91.1%,2,1.4%,3,2.1%
Venango,106617203,Titusville Area SD,126,75,59.5%,64,50.8%,81,64.3%,6,4.8%,11,8.7%
Bradford,117086503,Towanda Area SD,141,81,57.4%,75,53.2%,85,60.3%,4,2.8%,6,4.3%
Chester,124157802,Tredyffrin-Easttown SD,519,500,96.3%,498,96.0%,501,96.5%,1,0.2%,2,0.4%
Washington,101638003,Trinity Area SD,232,180,77.6%,168,72.4%,185,79.7%,5,2.2%,12,5.2%
Schuylkill,129547803,Tri-Valley SD,56,41,73.2%,29,51.8%,42,75.0%,1,1.8%,12,21.4%
Bradford,117086653,Troy Area SD,126,74,58.7%,66,52.4%,76,60.3%,2,1.6%,8,6.3%
Berks,114068003,Tulpehocken Area SD,136,82,60.3%,82,60.3%,87,64.0%,5,3.7%,0,0.0%
Wyoming,118667503,Tunkhannock Area SD,218,152,69.7%,148,67.9%,152,69.7%,0,0.0%,4,1.8%
Somerset,108568404,Turkeyfoot Valley Area SD,31,10,32.3%,10,32.3%,15,48.4%,5,16.1%,0,0.0%
Franklin,112286003,Tuscarora SD,170,98,57.6%,89,52.4%,102,60.0%,4,2.4%,9,5.3%
Bedford,108058003,Tussey Mountain SD,75,38,50.7%,29,38.7%,40,53.3%,2,2.7%,9,12.0%
Berks,114068103,Twin Valley SD,208,165,79.3%,158,76.0%,167,80.3%,2,1.0%,7,3.4%
Blair,108078003,Tyrone Area SD,139,95,68.3%,85,61.2%,107,77.0%,12,8.6%,10,7.2%
Lawrence,104377003,Union Area SD,59,47,79.7%,43,72.9%,50,84.7%,3,5.1%,4,6.8%
Erie,105259103,Union City Area SD,76,35,46.1%,34,44.7%,41,53.9%,6,7.9%,1,1.3%
Clarion,106169003,Union SD,47,26,55.3%,24,51.1%,26,55.3%,0,0.0%,2,4.3%
Fayette,101268003,Uniontown Area SD,209,130,62.2%,117,56.0%,132,63.2%,2,1.0%,13,6.2%
Chester,124158503,Unionville-Chadds Ford SD,372,340,91.4%,340,91.4%,343,92.2%,3,0.8%,0,0.0%
Indiana,128328003,United SD,91,58,63.7%,55,60.4%,62,68.1%,4,4.4%,3,3.3%
Adams,112018523,Upper Adams SD,134,108,80.6%,104,77.6%,112,83.6%,4,3.0%,4,3.0%
Delaware,125239452,Upper Darby SD,869,606,69.7%,583,67.1%,632,72.7%,26,3.0%,23,2.6%
Dauphin,115229003,Upper Dauphin Area SD,86,59,68.6%,39,45.3%,59,68.6%,0,0.0%,20,23.3%
Montgomery,123468303,Upper Dublin SD,379,358,94.5%,358,94.5%,358,94.5%,0,0.0%,0,0.0%
Montgomery,123468402,Upper Merion Area SD,299,248,82.9%,243,81.3%,253,84.6%,5,1.7%,5,1.7%
Montgomery,123468503,Upper Moreland Township SD,249,183,73.5%,180,72.3%,183,73.5%,0,0.0%,3,1.2%
Montgomery,123468603,Upper Perkiomen SD,235,180,76.6%,177,75.3%,180,76.6%,0,0.0%,3,1.3%
Allegheny,103029203,Upper Saint Clair SD,367,349,95.1%,349,95.1%,355,96.7%,6,1.6%,0,0.0%
Venango,106618603,Valley Grove SD,55,24,43.6%,19,34.5%,31,56.4%,7,12.7%,5,9.1%
Lackawanna,119358403,Valley View SD,184,152,82.6%,143,77.7%,155,84.2%,3,1.6%,9,4.9%
Pike,119648303,Wallenpaupack Area SD,339,208,61.4%,187,55.2%,208,61.4%,0,0.0%,21,6.2%
Delaware,125239603,Wallingford-Swarthmore SD,311,290,93.2%,290,93.2%,290,93.2%,0,0.0%,0,0.0%
Warren,105628302,Warren County SD,355,235,66.2%,223,62.8%,246,69.3%,11,3.1%,12,3.4%
Northumberland,116498003,Warrior Run SD,118,72,61.0%,72,61.0%,82,69.5%,10,8.5%,0,0.0%
Lancaster,113369003,Warwick SD,341,271,79.5%,264,77.4%,275,80.6%,4,1.2%,7,2.1%
Washington,101638803,Washington SD,102,68,66.7%,62,60.8%,68,66.7%,0,0.0%,6,5.9%
Erie,105259703,Wattsburg Area SD,123,70,56.9%,61,49.6%,82,66.7%,12,9.8%,9,7.3%
Wayne,119648703,Wayne Highlands SD,271,177,65.3%,173,63.8%,193,71.2%,16,5.9%,4,1.5%
Franklin,112289003,Waynesboro Area SD,264,154,58.3%,150,56.8%,161,61.0%,7,2.7%,4,1.5%
Carbon,121139004,Weatherly Area SD,48,34,70.8%,33,68.8%,35,72.9%,1,2.1%,1,2.1%
Tioga,117598503,Wellsboro Area SD,106,63,59.4%,63,59.4%,65,61.3%,2,1.9%,0,0.0%
Allegheny,103029403,West Allegheny SD,233,201,86.3%,190,81.5%,209,89.7%,8,3.4%,11,4.7%
Clearfield,110179003,West Branch Area SD,93,62,66.7%,52,55.9%,62,66.7%,0,0.0%,10,10.8%
Chester,124159002,West Chester Area SD,1001,884,88.3%,881,88.0%,898,89.7%,14,1.4%,3,0.3%
Greene,101308503,West Greene SD,59,38,64.4%,38,64.4%,38,64.4%,0,0.0%,0,0.0%
Allegheny,103029553,West Jefferson Hills SD,241,205,85.1%,196,81.3%,208,86.3%,3,1.2%,9,3.7%
Mercer,104437503,West Middlesex Area SD,63,48,76.2%,43,68.3%,51,81.0%,3,4.8%,5,7.9%
Allegheny,103029603,West Mifflin Area SD,278,195,70.1%,179,64.4%,204,73.4%,9,3.2%,16,5.8%
Perry,115508003,West Perry SD,204,134,65.7%,129,63.2%,138,67.6%,4,2.0%,5,2.5%
York,115219002,West Shore SD,593,438,73.9%,436,73.5%,442,74.5%,4,0.7%,2,0.3%
York,112678503,West York Area SD,242,180,74.4%,174,71.9%,194,80.2%,14,5.8%,6,2.5%
Beaver,127049303,Western Beaver County SD,58,44,75.9%,39,67.2%,46,79.3%,2,3.4%,5,8.6%
Wayne,119648903,Western Wayne SD,152,95,62.5%,93,61.2%,103,67.8%,8,5.3%,2,1.3%
Cambria,108118503,Westmont Hilltop SD,146,116,79.5%,116,79.5%,117,80.1%,1,0.7%,0,0.0%
Lehigh,121397803,Whitehall-Coplay SD,370,283,76.5%,283,76.5%,292,78.9%,9,2.4%,0,0.0%
Luzerne,118408852,Wilkes-Barre Area SD,540,0,0.0%,0,0.0%,0,0.0%,0,0.0%,0,0.0%
Allegheny,103029803,Wilkinsburg Borough SD,63,2,3.2%,1,1.6%,2,3.2%,0,0.0%,1,1.6%
Delaware,125239652,William Penn SD,339,133,39.2%,133,39.2%,141,41.6%,8,2.4%,0,0.0%
Schuylkill,129548803,Williams Valley SD,70,49,70.0%,43,61.4%,54,77.1%,5,7.1%,6,8.6%
Blair,108079004,Williamsburg Community SD,41,22,53.7%,16,39.0%,27,65.9%,5,12.2%,6,14.6%
Lycoming,117417202,Williamsport Area SD,416,240,57.7%,239,57.5%,242,58.2%,2,0.5%,1,0.2%
Lawrence,104378003,Wilmington Area SD,91,70,76.9%,66,72.5%,76,83.5%,6,6.6%,4,4.4%
Berks,114069103,Wilson  SD,435,317,72.9%,294,67.6%,322,74.0%,5,1.1%,23,5.3%
Northampton,120488603,Wilson Area SD,146,112,76.7%,109,74.7%,112,76.7%,0,0.0%,3,2.1%
Somerset,108569103,Windber Area SD,94,72,76.6%,69,73.4%,76,80.9%,4,4.3%,3,3.2%
Montgomery,123469303,Wissahickon SD,380,337,88.7%,337,88.7%,346,91.1%,9,2.4%,0,0.0%
Allegheny,103029902,Woodland Hills SD,313,226,72.2%,214,68.4%,234,74.8%,8,2.6%,12,3.8%
Bradford,117089003,Wyalusing Area SD,83,52,62.7%,52,62.7%,53,63.9%,1,1.2%,0,0.0%
Luzerne,118409203,Wyoming Area SD,199,175,87.9%,175,87.9%,177,88.9%,2,1.0%,0,0.0%
Luzerne,118409302,Wyoming Valley West SD,339,247,72.9%,245,72.3%,260,76.7%,13,3.8%,2,0.6%
Berks,114069353,Wyomissing Area SD,165,136,82.4%,128,77.6%,140,84.8%,4,2.4%,8,4.8%
York,112679002,York City SD,234,158,67.5%,158,67.5%,164,70.1%,6,2.6%,0,0.0%
York,112679403,York Suburban SD,203,175,86.2%,175,86.2%,176,86.7%,1,0.5%,0,0.0%
Westmoreland,107658903,Yough SD,150,102,68.0%,102,68.0%,107,71.3%,5,3.3%,0,0.0%