,school number,graduate count,college bound,total college bound %,2- or 4-year college or university,total postsecondary bound,total postsecondary bound %,non-degree-granting postsecondary school,non-degree-granting postsecondary school %,specialized associate degree granting institution
0,7691.0,135,87,64.4%,87,99,73.3%,12,8.9%,0
1,5091.0,297,257,86.5%,250,260,87.5%,3,1.0%,7
2,9999.0,1,0,0.0%,0,1,100.0%,1,100.0%,0
3,3241.0,582,521,89.5%,515,528,90.7%,7,1.2%,6
4,7846.0,59,40,67.8%,38,40,67.8%,0,0.0%,2
5,7824.0,129,26,20.2%,26,34,26.4%,8,6.2%,0
6,7858.0,881,296,33.6%,266,332,37.7%,36,4.1%,30
7,6001.0,261,121,46.4%,85,126,48.3%,5,1.9%,36
8,8086.0,72,40,55.6%,40,41,56.9%,1,1.4%,0
9,9999.0,2,0,0.0%,0,0,0.0%,0,0.0%,0
10,9999.0,8,2,25.0%,0,2,25.0%,0,0.0%,2
11,29.0,83,65,78.3%,61,67,80.7%,2,2.4%,4
12,4664.0,66,41,62.1%,37,41,62.1%,0,0.0%,4
13,9999.0,2,0,0.0%,0,0,0.0%,0,0.0%,0
14,9999.0,112,31,27.7%,29,38,33.9%,7,6.3%,2
15,2795.0,399,291,72.9%,270,306,76.7%,15,3.8%,21
16,2794.0,562,282,50.2%,274,300,53.4%,18,3.2%,8
17,913.0,506,329,65.0%,301,339,67.0%,10,2.0%,28
18,7425.0,9,0,0.0%,0,0,0.0%,0,0.0%,0
19,6555.0,167,112,67.1%,104,112,67.1%,0,0.0%,8
20,9999.0,1,0,0.0%,0,0,0.0%,0,0.0%,0
21,2725.0,110,65,59.1%,65,69,62.7%,4,3.6%,0
22,820.0,72,65,90.3%,56,65,90.3%,0,0.0%,9
23,9999.0,4,0,0.0%,0,0,0.0%,0,0.0%,0
24,2320.0,84,59,70.2%,52,63,75.0%,4,4.8%,7
25,9999.0,7,0,0.0%,0,0,0.0%,0,0.0%,0
26,582.0,45,29,64.4%,26,30,66.7%,1,2.2%,3
27,6575.0,90,69,76.7%,64,71,78.9%,2,2.2%,5
28,596.0,114,84,73.7%,75,85,74.6%,1,0.9%,9
29,7640.0,55,33,60.0%,33,33,60.0%,0,0.0%,0
30,8148.0,18,16,88.9%,16,17,94.4%,1,5.6%,0
31,958.0,140,66,47.1%,65,66,47.1%,0,0.0%,1
32,6222.0,16,10,62.5%,10,11,68.8%,1,6.3%,0
33,4165.0,51,38,74.5%,38,38,74.5%,0,0.0%,0
34,7721.0,45,41,91.1%,41,44,97.8%,3,6.7%,0
35,1367.0,415,320,77.1%,316,327,78.8%,7,1.7%,4
36,9999.0,3,0,0.0%,0,0,0.0%,0,0.0%,0
37,5199.0,99,82,82.8%,82,85,85.9%,3,3.0%,0
38,9999.0,2,0,0.0%,0,0,0.0%,0,0.0%,0
39,1335.0,146,93,63.7%,78,96,65.8%,3,2.1%,15
40,50.0,363,311,85.7%,301,319,87.9%,8,2.2%,10
41,9999.0,3,0,0.0%,0,0,0.0%,0,0.0%,0
42,3434.0,268,203,75.7%,202,207,77.2%,4,1.5%,1
43,7847.0,18,8,44.4%,7,8,44.4%,0,0.0%,1
44,640.0,162,134,82.7%,129,136,84.0%,2,1.2%,5
45,9999.0,2,0,0.0%,0,0,0.0%,0,0.0%,0
46,726.0,149,82,55.0%,79,84,56.4%,2,1.3%,3
47,4930.0,204,141,69.1%,135,149,73.0%,8,3.9%,6
48,9999.0,1,0,0.0%,0,0,0.0%,0,0.0%,0
49,1343.0,222,149,67.1%,134,158,71.2%,9,4.1%,15
50,917.0,104,69,66.3%,69,82,78.8%,13,12.5%,0
51,9999.0,18,0,0.0%,0,0,0.0%,0,0.0%,0
52,5116.0,428,341,79.7%,341,369,86.2%,28,6.5%,0
53,1595.0,49,26,53.1%,26,27,55.1%,1,2.0%,0
54,9999.0,4,0,0.0%,0,0,0.0%,0,0.0%,0
55,4188.0,85,61,71.8%,53,61,71.8%,0,0.0%,8
56,6207.0,70,41,58.6%,36,44,62.9%,3,4.3%,5
57,3.0,135,100,74.1%,99,100,74.1%,0,0.0%,1
58,9999.0,1,0,0.0%,0,0,0.0%,0,0.0%,0
59,1605.0,233,171,73.4%,170,175,75.1%,4,1.7%,1
60,9999.0,1,0,0.0%,0,0,0.0%,0,0.0%,0
61,62.0,395,356,90.1%,345,357,90.4%,1,0.3%,11
62,9999.0,17,0,0.0%,0,0,0.0%,0,0.0%,0
63,9999.0,1,0,0.0%,0,0,0.0%,0,0.0%,0
64,4957.0,453,402,88.7%,388,406,89.6%,4,0.9%,14
65,3465.0,615,498,81.0%,496,503,81.8%,5,0.8%,2
66,4181.0,86,55,64.0%,51,62,72.1%,7,8.1%,4
67,649.0,130,80,61.5%,70,81,62.3%,1,0.8%,10
68,9999.0,2,0,0.0%,0,0,0.0%,0,0.0%,0
69,1677.0,205,121,59.0%,115,123,60.0%,2,1.0%,6
70,6707.0,206,163,79.1%,156,177,85.9%,14,6.8%,7
71,9999.0,1,0,0.0%,0,0,0.0%,0,0.0%,0
72,5135.0,40,28,70.0%,24,30,75.0%,2,5.0%,4
73,4706.0,104,78,75.0%,72,78,75.0%,0,0.0%,6
74,2353.0,43,27,62.8%,23,29,67.4%,2,4.7%,4
75,1612.0,94,71,75.5%,68,75,79.8%,4,4.3%,3
76,3891.0,229,160,69.9%,146,170,74.2%,10,4.4%,14
77,9999.0,1,0,0.0%,0,0,0.0%,0,0.0%,0
78,4034.0,77,39,50.6%,39,42,54.5%,3,3.9%,0
79,6306.0,538,432,80.3%,410,435,80.9%,3,0.6%,22
80,7981.0,72,69,95.8%,69,71,98.6%,2,2.8%,0
81,4691.0,203,142,70.0%,127,151,74.4%,9,4.4%,15
82,9999.0,7,0,0.0%,0,0,0.0%,0,0.0%,0
83,9999.0,4,0,0.0%,0,0,0.0%,0,0.0%,0
84,6308.0,148,110,74.3%,104,113,76.4%,3,2.0%,6
85,70.0,113,96,85.0%,90,98,86.7%,2,1.8%,6
86,9999.0,5,0,0.0%,0,0,0.0%,0,0.0%,0
87,1014.0,70,52,74.3%,52,60,85.7%,8,11.4%,0
88,9999.0,45,0,0.0%,0,0,0.0%,0,0.0%,0
89,1029.0,381,299,78.5%,279,308,80.8%,9,2.4%,20
90,2362.0,94,62,66.0%,60,62,66.0%,0,0.0%,2
91,6162.0,111,77,69.4%,75,82,73.9%,5,4.5%,2
92,4818.0,103,73,70.9%,67,73,70.9%,0,0.0%,6
93,1030.0,306,197,64.4%,193,215,70.3%,18,5.9%,4
94,4195.0,83,54,65.1%,54,61,73.5%,7,8.4%,0
95,4340.0,148,126,85.1%,120,128,86.5%,2,1.4%,6
96,9999.0,1,0,0.0%,0,0,0.0%,0,0.0%,0
97,6690.0,1,0,0.0%,0,0,0.0%,0,0.0%,0
98,9999.0,42,3,7.1%,3,4,9.5%,1,2.4%,0
99,1147.0,556,449,80.8%,430,459,82.6%,10,1.8%,19
100,4203.0,63,46,73.0%,45,47,74.6%,1,1.6%,1
101,5212.0,112,76,67.9%,68,79,70.5%,3,2.7%,8
102,1299.0,53,31,58.5%,27,32,60.4%,1,1.9%,4
103,1682.0,106,101,95.3%,98,101,95.3%,0,0.0%,3
104,9999.0,6,1,16.7%,1,1,16.7%,0,0.0%,0
105,4217.0,335,280,83.6%,242,284,84.8%,4,1.2%,38
106,988.0,76,39,51.3%,39,39,51.3%,0,0.0%,0
107,4870.0,76,37,48.7%,37,48,63.2%,11,14.5%,0
108,2420.0,94,66,70.2%,63,75,79.8%,9,9.6%,3
109,7457.0,1,1,100.0%,1,1,100.0%,0,0.0%,0
110,7577.0,51,28,54.9%,26,29,56.9%,1,2.0%,2
111,1694.0,325,223,68.6%,194,223,68.6%,0,0.0%,29
112,9999.0,12,0,0.0%,0,0,0.0%,0,0.0%,0
113,79.0,100,76,76.0%,69,76,76.0%,0,0.0%,7
114,9999.0,9,2,22.2%,1,2,22.2%,0,0.0%,1
115,7112.0,58,38,65.5%,37,38,65.5%,0,0.0%,1
116,2798.0,123,97,78.9%,90,99,80.5%,2,1.6%,7
117,9999.0,7,0,0.0%,0,0,0.0%,0,0.0%,0
118,1040.0,419,347,82.8%,343,359,85.7%,12,2.9%,4
119,7726.0,27,12,44.4%,12,13,48.1%,1,3.7%,0
120,5133.0,515,487,94.6%,478,489,95.0%,2,0.4%,9
121,7790.0,584,524,89.7%,524,526,90.1%,2,0.3%,0
122,1043.0,458,420,91.7%,417,422,92.1%,2,0.4%,3
123,9999.0,18,0,0.0%,0,0,0.0%,0,0.0%,0
124,1208.0,160,120,75.0%,110,123,76.9%,3,1.9%,10
125,9999.0,2,0,0.0%,0,0,0.0%,0,0.0%,0
126,1619.0,157,124,79.0%,124,124,79.0%,0,0.0%,0
127,1746.0,330,243,73.6%,233,251,76.1%,8,2.4%,10
128,9999.0,5,0,0.0%,0,0,0.0%,0,0.0%,0
129,1745.0,420,355,84.5%,349,360,85.7%,5,1.2%,6
130,6252.0,54,38,70.4%,36,38,70.4%,0,0.0%,2
131,9999.0,1,0,0.0%,0,0,0.0%,0,0.0%,0
132,5118.0,150,85,56.7%,76,85,56.7%,0,0.0%,9
133,7720.0,14,8,57.1%,7,9,64.3%,1,7.1%,1
134,8044.0,187,154,82.4%,147,158,84.5%,4,2.1%,7
135,4545.0,408,333,81.6%,310,340,83.3%,7,1.7%,23
136,9999.0,1,1,100.0%,1,1,100.0%,0,0.0%,0
137,9999.0,3,0,0.0%,0,0,0.0%,0,0.0%,0
138,2191.0,593,319,53.8%,310,325,54.8%,6,1.0%,9
139,4715.0,136,98,72.1%,73,100,73.5%,2,1.5%,25
140,7578.0,154,138,89.6%,138,144,93.5%,6,3.9%,0
141,6706.0,273,242,88.6%,234,245,89.7%,3,1.1%,8
142,4235.0,87,63,72.4%,58,63,72.4%,0,0.0%,5
143,3260.0,341,283,83.0%,281,286,83.9%,3,0.9%,2
144,9999.0,5,2,40.0%,2,2,40.0%,0,0.0%,0
145,7293.0,201,136,67.7%,135,141,70.1%,5,2.5%,1
146,6492.0,185,101,54.6%,101,102,55.1%,1,0.5%,0
147,8022.0,56,56,100.0%,56,56,100.0%,0,0.0%,0
148,8023.0,71,46,64.8%,45,46,64.8%,0,0.0%,1
149,732.0,113,58,51.3%,42,65,57.5%,7,6.2%,16
150,9999.0,2,0,0.0%,0,0,0.0%,0,0.0%,0
151,1849.0,239,150,62.8%,143,165,69.0%,15,6.3%,7
152,7727.0,124,116,93.5%,115,116,93.5%,0,0.0%,1
153,9999.0,5,0,0.0%,0,0,0.0%,0,0.0%,0
154,8094.0,36,23,63.9%,21,24,66.7%,1,2.8%,2
155,1475.0,50,42,84.0%,42,42,84.0%,0,0.0%,0
156,9999.0,1,0,0.0%,0,0,0.0%,0,0.0%,0
157,1480.0,87,59,67.8%,57,65,74.7%,6,6.9%,2
158,9999.0,3,0,0.0%,0,0,0.0%,0,0.0%,0
159,921.0,69,0,0.0%,0,0,0.0%,0,0.0%,0
160,6236.0,205,102,49.8%,86,116,56.6%,14,6.8%,16
161,9999.0,22,1,4.5%,1,1,4.5%,0,0.0%,0
162,5012.0,524,356,67.9%,356,429,81.9%,73,13.9%,0
163,9999.0,10,0,0.0%,0,0,0.0%,0,0.0%,0
164,6290.0,275,148,53.8%,142,151,54.9%,3,1.1%,6
165,7628.0,42,39,92.9%,39,40,95.2%,1,2.4%,0
166,9999.0,2,0,0.0%,0,0,0.0%,0,0.0%,0
167,3333.0,407,363,89.2%,361,367,90.2%,4,1.0%,2
168,2515.0,82,48,58.5%,39,50,61.0%,2,2.4%,9
169,5178.0,147,57,38.8%,50,66,44.9%,9,6.1%,7
170,6122.0,43,29,67.4%,28,31,72.1%,2,4.7%,1
171,7774.0,409,264,64.5%,264,264,64.5%,0,0.0%,0
172,7510.0,131,89,67.9%,89,97,74.0%,8,6.1%,0
173,9999.0,1,0,0.0%,0,0,0.0%,0,0.0%,0
174,3978.0,77,54,70.1%,50,56,72.7%,2,2.6%,4
175,5136.0,69,54,78.3%,51,58,84.1%,4,5.8%,3
176,9999.0,5,1,20.0%,1,1,20.0%,0,0.0%,0
177,2532.0,310,215,69.4%,212,218,70.3%,3,1.0%,3
178,9999.0,4,2,50.0%,2,3,75.0%,1,25.0%,0
179,17.0,303,210,69.3%,181,210,69.3%,0,0.0%,29
180,1637.0,70,39,55.7%,39,49,70.0%,10,14.3%,0
181,9999.0,1,0,0.0%,0,0,0.0%,0,0.0%,0
182,1639.0,60,35,58.3%,27,36,60.0%,1,1.7%,8
183,1644.0,73,39,53.4%,32,44,60.3%,5,6.8%,7
184,6643.0,81,0,0.0%,0,1,1.2%,1,1.2%,0
185,5228.0,255,167,65.5%,166,191,74.9%,24,9.4%,1
186,9999.0,8,2,25.0%,2,4,50.0%,2,25.0%,0
187,777.0,245,172,70.2%,161,194,79.2%,22,9.0%,11
188,8087.0,60,53,88.3%,50,54,90.0%,1,1.7%,3
189,4800.0,375,288,76.8%,265,296,78.9%,8,2.1%,23
190,9999.0,9,0,0.0%,0,0,0.0%,0,0.0%,0
191,1998.0,204,98,48.0%,84,111,54.4%,13,6.4%,14
192,3869.0,62,30,48.4%,30,32,51.6%,2,3.2%,0
193,5096.0,557,531,95.3%,530,538,96.6%,7,1.3%,1
194,7749.0,487,457,93.8%,457,464,95.3%,7,1.4%,0
195,9999.0,9,0,0.0%,0,1,11.1%,1,11.1%,0
196,4098.0,77,54,70.1%,44,57,74.0%,3,3.9%,10
197,9999.0,10,0,0.0%,0,0,0.0%,0,0.0%,0
198,1632.0,70,46,65.7%,44,48,68.6%,2,2.9%,2
199,9999.0,1,0,0.0%,0,0,0.0%,0,0.0%,0
200,1654.0,231,150,64.9%,132,153,66.2%,3,1.3%,18
201,2860.0,265,233,87.9%,225,233,87.9%,0,0.0%,8
202,7624.0,39,2,5.1%,2,4,10.3%,2,5.1%,0
203,1701.0,595,475,79.8%,472,478,80.3%,3,0.5%,3
204,9999.0,1,0,0.0%,0,0,0.0%,0,0.0%,0
205,1529.0,72,45,62.5%,37,49,68.1%,4,5.6%,8
206,9999.0,2,0,0.0%,0,0,0.0%,0,0.0%,0
207,2869.0,213,183,85.9%,179,186,87.3%,3,1.4%,4
208,9999.0,17,1,5.9%,1,2,11.8%,1,5.9%,0
209,4553.0,456,342,75.0%,330,358,78.5%,16,3.5%,12
210,4810.0,268,0,0.0%,0,0,0.0%,0,0.0%,0
211,9999.0,10,0,0.0%,0,0,0.0%,0,0.0%,0
212,3425.0,178,144,80.9%,136,148,83.1%,4,2.2%,8
213,5278.0,166,77,46.4%,66,79,47.6%,2,1.2%,11
214,513.0,134,102,76.1%,102,112,83.6%,10,7.5%,0
215,9999.0,2,0,0.0%,0,0,0.0%,0,0.0%,0
216,7671.0,184,184,100.0%,184,184,100.0%,0,0.0%,0
217,5261.0,416,364,87.5%,317,366,88.0%,2,0.5%,47
218,9999.0,6,0,0.0%,0,0,0.0%,0,0.0%,0
219,4352.0,165,126,76.4%,112,130,78.8%,4,2.4%,14
220,9999.0,3,0,0.0%,0,0,0.0%,0,0.0%,0
221,4801.0,256,235,91.8%,233,239,93.4%,4,1.6%,2
222,9999.0,1,0,0.0%,0,0,0.0%,0,0.0%,0
223,2539.0,219,147,67.1%,136,149,68.0%,2,0.9%,11
224,4558.0,214,145,67.8%,136,152,71.0%,7,3.3%,9
225,9999.0,4,1,25.0%,1,2,50.0%,1,25.0%,0
226,9999.0,22,1,4.5%,1,1,4.5%,0,0.0%,0
227,7759.0,447,423,94.6%,423,431,96.4%,8,1.8%,0
228,1387.0,389,344,88.4%,344,352,90.5%,8,2.1%,0
229,7550.0,44,15,34.1%,13,20,45.5%,5,11.4%,2
230,9999.0,3,0,0.0%,0,0,0.0%,0,0.0%,0
231,6156.0,275,188,68.4%,171,194,70.5%,6,2.2%,17
232,2429.0,120,97,80.8%,91,100,83.3%,3,2.5%,6
233,5193.0,143,102,71.3%,95,112,78.3%,10,7.0%,7
234,9999.0,8,1,12.5%,1,1,12.5%,0,0.0%,0
235,6364.0,131,97,74.0%,88,97,74.0%,0,0.0%,9
236,2809.0,607,488,80.4%,486,496,81.7%,8,1.3%,2
237,1707.0,198,158,79.8%,152,159,80.3%,1,0.5%,6
238,7641.0,312,231,74.0%,231,257,82.4%,26,8.3%,0
239,6935.0,335,262,78.2%,262,281,83.9%,19,5.7%,0
240,2554.0,274,174,63.5%,153,177,64.6%,3,1.1%,21
241,2740.0,171,119,69.6%,118,122,71.3%,3,1.8%,1
242,9999.0,3,0,0.0%,0,0,0.0%,0,0.0%,0
243,4564.0,189,123,65.1%,103,140,74.1%,17,9.0%,20
244,9999.0,10,0,0.0%,0,0,0.0%,0,0.0%,0
245,3482.0,639,525,82.2%,516,539,84.4%,14,2.2%,9
246,144.0,222,154,69.4%,143,158,71.2%,4,1.8%,11
247,2562.0,305,206,67.5%,199,213,69.8%,7,2.3%,7
248,6418.0,80,48,60.0%,48,52,65.0%,4,5.0%,0
249,2675.0,118,86,72.9%,86,101,85.6%,15,12.7%,0
250,6293.0,313,190,60.7%,181,212,67.7%,22,7.0%,9
251,7294.0,165,92,55.8%,68,93,56.4%,1,0.6%,24
252,2026.0,201,124,61.7%,123,124,61.7%,0,0.0%,1
253,7515.0,219,212,96.8%,212,212,96.8%,0,0.0%,0
254,2027.0,202,149,73.8%,138,153,75.7%,4,2.0%,11
255,7665.0,175,141,80.6%,131,150,85.7%,9,5.1%,10
256,7897.0,118,52,44.1%,52,56,47.5%,4,3.4%,0
257,7866.0,10,10,100.0%,9,10,100.0%,0,0.0%,1
258,9999.0,4,1,25.0%,1,1,25.0%,0,0.0%,0
259,788.0,332,252,75.9%,245,266,80.1%,14,4.2%,7
260,6269.0,96,63,65.6%,59,70,72.9%,7,7.3%,4
261,6737.0,147,114,77.6%,113,122,83.0%,8,5.4%,1
262,9999.0,1,0,0.0%,0,0,0.0%,0,0.0%,0
263,2201.0,52,24,46.2%,24,28,53.8%,4,7.7%,0
264,5248.0,60,42,70.0%,35,45,75.0%,3,5.0%,7
265,1225.0,64,44,68.8%,44,47,73.4%,3,4.7%,0
266,5023.0,200,151,75.5%,138,151,75.5%,0,0.0%,13
267,2246.0,36,21,58.3%,21,21,58.3%,0,0.0%,0
268,6159.0,24,13,54.2%,12,14,58.3%,1,4.2%,1
269,9999.0,1,0,0.0%,0,0,0.0%,0,0.0%,0
270,6161.0,32,23,71.9%,21,23,71.9%,0,0.0%,2
271,6419.0,68,45,66.2%,44,48,70.6%,3,4.4%,1
272,9999.0,1,0,0.0%,0,0,0.0%,0,0.0%,0
273,1191.0,175,121,69.1%,116,129,73.7%,8,4.6%,5
274,4242.0,86,61,70.9%,60,61,70.9%,0,0.0%,1
275,9999.0,5,0,0.0%,0,0,0.0%,0,0.0%,0
276,2037.0,178,132,74.2%,125,144,80.9%,12,6.7%,7
277,156.0,364,327,89.8%,321,332,91.2%,5,1.4%,6
278,9999.0,6,1,16.7%,1,1,16.7%,0,0.0%,0
279,4106.0,155,88,56.8%,79,96,61.9%,8,5.2%,9
280,4360.0,307,266,86.6%,260,267,87.0%,1,0.3%,6
281,7666.0,214,0,0.0%,0,0,0.0%,0,0.0%,0
282,2126.0,78,49,62.8%,48,49,62.8%,0,0.0%,1
283,6563.0,124,91,73.4%,91,93,75.0%,2,1.6%,0
284,9999.0,1,0,0.0%,0,0,0.0%,0,0.0%,0
285,594.0,139,108,77.7%,105,114,82.0%,6,4.3%,3
286,7586.0,68,63,92.6%,61,63,92.6%,0,0.0%,2
287,6223.0,19,12,63.2%,8,13,68.4%,1,5.3%,4
288,1869.0,377,344,91.2%,337,346,91.8%,2,0.5%,7
289,9999.0,2,0,0.0%,0,0,0.0%,0,0.0%,0
290,170.0,341,304,89.1%,293,313,91.8%,9,2.6%,11
291,2040.0,174,131,75.3%,123,131,75.3%,0,0.0%,8
292,9999.0,2,0,0.0%,0,0,0.0%,0,0.0%,0
293,6271.0,233,156,67.0%,137,163,70.0%,7,3.0%,19
294,9999.0,3,0,0.0%,0,0,0.0%,0,0.0%,0
295,2043.0,140,91,65.0%,74,92,65.7%,1,0.7%,17
296,9999.0,4,0,0.0%,0,0,0.0%,0,0.0%,0
297,5219.0,54,38,70.4%,27,41,75.9%,3,5.6%,11
298,9999.0,2,0,0.0%,0,0,0.0%,0,0.0%,0
299,802.0,300,204,68.0%,200,214,71.3%,10,3.3%,4
300,1424.0,291,269,92.4%,269,270,92.8%,1,0.3%,0
301,9999.0,11,0,0.0%,0,0,0.0%,0,0.0%,0
302,1251.0,226,152,67.3%,130,152,67.3%,0,0.0%,22
303,9999.0,4,0,0.0%,0,0,0.0%,0,0.0%,0
304,4845.0,356,304,85.4%,300,307,86.2%,3,0.8%,4
305,9999.0,6,1,16.7%,1,1,16.7%,0,0.0%,0
306,5242.0,154,110,71.4%,110,111,72.1%,1,0.6%,0
307,2206.0,197,130,66.0%,121,133,67.5%,3,1.5%,9
308,9999.0,5,0,0.0%,0,0,0.0%,0,0.0%,0
309,4373.0,233,165,70.8%,154,165,70.8%,0,0.0%,11
310,3137.0,124,87,70.2%,83,89,71.8%,2,1.6%,4
311,6341.0,53,42,79.2%,42,42,79.2%,0,0.0%,0
312,6125.0,60,42,70.0%,29,42,70.0%,0,0.0%,13
313,3145.0,168,129,76.8%,126,135,80.4%,6,3.6%,3
314,6330.0,90,70,77.8%,62,72,80.0%,2,2.2%,8
315,808.0,191,141,73.8%,123,147,77.0%,6,3.1%,18
316,9999.0,2,0,0.0%,0,0,0.0%,0,0.0%,0
317,5190.0,252,231,91.7%,227,234,92.9%,3,1.2%,4
318,2891.0,147,113,76.9%,112,118,80.3%,5,3.4%,1
319,9999.0,2,0,0.0%,0,0,0.0%,0,0.0%,0
320,9999.0,4,0,0.0%,0,0,0.0%,0,0.0%,0
321,4571.0,112,44,39.3%,44,45,40.2%,1,0.9%,0
322,9999.0,2,0,0.0%,0,0,0.0%,0,0.0%,0
323,7948.0,176,113,64.2%,113,128,72.7%,15,8.5%,0
324,1547.0,33,16,48.5%,6,19,57.6%,3,9.1%,10
325,9999.0,2,0,0.0%,0,0,0.0%,0,0.0%,0
326,6333.0,250,222,88.8%,220,223,89.2%,1,0.4%,2
327,7902.0,74,72,97.3%,72,72,97.3%,0,0.0%,0
328,9999.0,10,1,10.0%,1,1,10.0%,0,0.0%,0
329,3272.0,404,349,86.4%,348,351,86.9%,2,0.5%,1
330,1879.0,461,398,86.3%,389,403,87.4%,5,1.1%,9
331,9999.0,8,3,37.5%,3,3,37.5%,0,0.0%,0
332,7348.0,715,476,66.6%,454,492,68.8%,16,2.2%,22
333,9999.0,15,4,26.7%,3,4,26.7%,0,0.0%,1
334,2578.0,543,440,81.0%,419,452,83.2%,12,2.2%,21
335,7747.0,4,0,0.0%,0,0,0.0%,0,0.0%,0
336,4404.0,441,386,87.5%,378,389,88.2%,3,0.7%,8
337,3150.0,179,137,76.5%,128,141,78.8%,4,2.2%,9
338,5153.0,196,125,63.8%,125,149,76.0%,24,12.2%,0
339,5207.0,264,170,64.4%,170,180,68.2%,10,3.8%,0
340,2331.0,69,51,73.9%,51,51,73.9%,0,0.0%,0
341,7723.0,1,0,0.0%,0,0,0.0%,0,0.0%,0
342,8154.0,27,12,44.4%,12,12,44.4%,0,0.0%,0
343,9999.0,10,0,0.0%,0,0,0.0%,0,0.0%,0
344,675.0,196,136,69.4%,128,141,71.9%,5,2.6%,8
345,2305.0,162,95,58.6%,91,103,63.6%,8,4.9%,4
346,8155.0,21,16,76.2%,16,16,76.2%,0,0.0%,0
347,7542.0,119,111,93.3%,111,111,93.3%,0,0.0%,0
348,2325.0,190,156,82.1%,155,160,84.2%,4,2.1%,1
349,9999.0,7,1,14.3%,1,1,14.3%,0,0.0%,0
350,1885.0,309,254,82.2%,245,268,86.7%,14,4.5%,9
351,4817.0,93,59,63.4%,56,67,72.0%,8,8.6%,3
352,6126.0,45,31,68.9%,25,31,68.9%,0,0.0%,6
353,9999.0,6,0,0.0%,0,0,0.0%,0,0.0%,0
354,4412.0,77,57,74.0%,54,59,76.6%,2,2.6%,3
355,5180.0,101,36,35.6%,29,38,37.6%,2,2.0%,7
356,2280.0,45,30,66.7%,29,33,73.3%,3,6.7%,1
357,8049.0,48,38,79.2%,38,38,79.2%,0,0.0%,0
358,9999.0,1,0,0.0%,0,0,0.0%,0,0.0%,0
359,3034.0,183,108,59.0%,104,108,59.0%,0,0.0%,4
360,9999.0,1,0,0.0%,0,0,0.0%,0,0.0%,0
361,1307.0,124,98,79.0%,91,103,83.1%,5,4.0%,7
362,6218.0,48,32,66.7%,30,33,68.8%,1,2.1%,2
363,2394.0,91,47,51.6%,43,48,52.7%,1,1.1%,4
364,6255.0,147,75,51.0%,58,75,51.0%,0,0.0%,17
365,2308.0,70,37,52.9%,35,40,57.1%,3,4.3%,2
366,5245.0,65,48,73.8%,48,48,73.8%,0,0.0%,0
367,1154.0,122,89,73.0%,80,91,74.6%,2,1.6%,9
368,9999.0,11,2,18.2%,2,2,18.2%,0,0.0%,0
369,6482.0,297,224,75.4%,224,224,75.4%,0,0.0%,0
370,9999.0,5,0,0.0%,0,0,0.0%,0,0.0%,0
371,1486.0,84,45,53.6%,42,46,54.8%,1,1.2%,3
372,6241.0,30,20,66.7%,20,21,70.0%,1,3.3%,0
373,7589.0,324,162,50.0%,140,168,51.9%,6,1.9%,22
374,7506.0,52,22,42.3%,20,22,42.3%,0,0.0%,2
375,5112.0,169,124,73.4%,120,127,75.1%,3,1.8%,4
376,9999.0,1,0,0.0%,0,0,0.0%,0,0.0%,0
377,4431.0,299,250,83.6%,231,252,84.3%,2,0.7%,19
378,816.0,111,80,72.1%,77,80,72.1%,0,0.0%,3
379,7538.0,22,13,59.1%,8,15,68.2%,2,9.1%,5
380,4528.0,100,66,66.0%,66,68,68.0%,2,2.0%,0
381,9999.0,1,0,0.0%,0,0,0.0%,0,0.0%,0
382,6404.0,134,110,82.1%,103,113,84.3%,3,2.2%,7
383,2924.0,147,128,87.1%,126,130,88.4%,2,1.4%,2
384,9999.0,14,0,0.0%,0,0,0.0%,0,0.0%,0
385,3155.0,94,56,59.6%,54,70,74.5%,14,14.9%,2
386,2607.0,259,208,80.3%,199,212,81.9%,4,1.5%,9
387,7403.0,18,4,22.2%,4,4,22.2%,0,0.0%,0
388,9999.0,3,0,0.0%,0,0,0.0%,0,0.0%,0
389,2596.0,535,368,68.8%,354,385,72.0%,17,3.2%,14
390,7922.0,70,48,68.6%,43,54,77.1%,6,8.6%,5
391,6600.0,244,169,69.3%,161,179,73.4%,10,4.1%,8
392,2680.0,118,99,83.9%,76,100,84.7%,1,0.8%,23
393,4940.0,100,47,47.0%,42,49,49.0%,2,2.0%,5
394,9999.0,4,0,0.0%,0,0,0.0%,0,0.0%,0
395,5155.0,187,118,63.1%,118,118,63.1%,0,0.0%,0
396,7923.0,48,33,68.8%,33,42,87.5%,9,18.8%,0
397,7681.0,35,32,91.4%,32,33,94.3%,1,2.9%,0
398,7634.0,113,105,92.9%,104,109,96.5%,4,3.5%,1
399,1315.0,186,149,80.1%,149,149,80.1%,0,0.0%,0
400,4807.0,171,63,36.8%,58,84,49.1%,21,12.3%,5
401,9999.0,2,0,0.0%,0,0,0.0%,0,0.0%,0
402,4085.0,143,119,83.2%,118,121,84.6%,2,1.4%,1
403,4442.0,159,111,69.8%,107,129,81.1%,18,11.3%,4
404,7859.0,123,99,80.5%,99,104,84.6%,5,4.1%,0
405,3532.0,101,61,60.4%,55,69,68.3%,8,7.9%,6
406,9999.0,1,0,0.0%,0,0,0.0%,0,0.0%,0
407,14.0,161,93,57.8%,90,95,59.0%,2,1.2%,3
408,1776.0,301,199,66.1%,199,199,66.1%,0,0.0%,0
409,7844.0,4,0,0.0%,0,0,0.0%,0,0.0%,0
410,3296.0,204,194,95.1%,192,198,97.1%,4,2.0%,2
411,3295.0,330,299,90.6%,299,302,91.5%,3,0.9%,0
412,9999.0,6,3,50.0%,3,3,50.0%,0,0.0%,0
413,4960.0,171,161,94.2%,161,163,95.3%,2,1.2%,0
414,9999.0,2,0,0.0%,0,1,50.0%,1,50.0%,0
415,4828.0,111,92,82.9%,92,92,82.9%,0,0.0%,0
416,7012.0,75,51,68.0%,49,52,69.3%,1,1.3%,2
417,9999.0,1,0,0.0%,0,0,0.0%,0,0.0%,0
418,9999.0,247,160,64.8%,158,163,66.0%,3,1.2%,2
419,2618.0,217,145,66.8%,130,147,67.7%,2,0.9%,15
420,2623.0,469,348,74.2%,348,348,74.2%,0,0.0%,0
421,7672.0,98,79,80.6%,79,80,81.6%,1,1.0%,0
422,2339.0,116,74,63.8%,64,81,69.8%,7,6.0%,10
423,7777.0,64,64,100.0%,64,64,100.0%,0,0.0%,0
424,9999.0,2,0,0.0%,0,0,0.0%,0,0.0%,0
425,1902.0,290,252,86.9%,250,260,89.7%,8,2.8%,2
426,9999.0,1,0,0.0%,0,1,100.0%,1,100.0%,0
427,1159.0,213,203,95.3%,199,203,95.3%,0,0.0%,4
428,7574.0,95,91,95.8%,91,92,96.8%,1,1.1%,0
429,7678.0,67,61,91.0%,61,65,97.0%,4,6.0%,0
430,8207.0,215,164,76.3%,158,173,80.5%,9,4.2%,6
431,7961.0,73,67,91.8%,65,69,94.5%,2,2.7%,2
432,7909.0,97,93,95.9%,93,93,95.9%,0,0.0%,0
433,7910.0,77,68,88.3%,64,70,90.9%,2,2.6%,4
434,7582.0,57,57,100.0%,52,57,100.0%,0,0.0%,5
435,4249.0,154,113,73.4%,110,113,73.4%,0,0.0%,3
436,9999.0,1,0,0.0%,0,0,0.0%,0,0.0%,0
437,6105.0,271,196,72.3%,176,200,73.8%,4,1.5%,20
438,5098.0,266,215,80.8%,210,223,83.8%,8,3.0%,5
439,3158.0,108,69,63.9%,66,70,64.8%,1,0.9%,3
440,3305.0,441,405,91.8%,401,405,91.8%,0,0.0%,4
441,3994.0,64,37,57.8%,37,45,70.3%,8,12.5%,0
442,7890.0,117,69,59.0%,66,74,63.2%,5,4.3%,3
443,1790.0,154,125,81.2%,122,129,83.8%,4,2.6%,3
444,9999.0,5,1,20.0%,1,3,60.0%,2,40.0%,0
445,3962.0,143,71,49.7%,68,71,49.7%,0,0.0%,3
446,9999.0,2,0,0.0%,0,0,0.0%,0,0.0%,0
447,8187.0,382,204,53.4%,168,218,57.1%,14,3.7%,36
448,9999.0,3,0,0.0%,0,0,0.0%,0,0.0%,0
449,4091.0,175,109,62.3%,109,111,63.4%,2,1.1%,0
450,8071.0,527,398,75.5%,372,408,77.4%,10,1.9%,26
451,7995.0,20,5,25.0%,5,5,25.0%,0,0.0%,0
452,9999.0,1,0,0.0%,0,0,0.0%,0,0.0%,0
453,7471.0,23,10,43.5%,9,16,69.6%,6,26.1%,1
454,1794.0,68,53,77.9%,51,54,79.4%,1,1.5%,2
455,1623.0,46,38,82.6%,37,38,82.6%,0,0.0%,1
456,9999.0,4,0,0.0%,0,0,0.0%,0,0.0%,0
457,3541.0,156,91,58.3%,81,93,59.6%,2,1.3%,10
458,6583.0,85,61,71.8%,57,61,71.8%,0,0.0%,4
459,9999.0,2,0,0.0%,0,0,0.0%,0,0.0%,0
460,2686.0,107,73,68.2%,69,77,72.0%,4,3.7%,4
461,6181.0,74,55,74.3%,55,55,74.3%,0,0.0%,0
462,1164.0,107,58,54.2%,56,69,64.5%,11,10.3%,2
463,3040.0,57,29,50.9%,26,29,50.9%,0,0.0%,3
464,5017.0,247,211,85.4%,210,212,85.8%,1,0.4%,1
465,9999.0,5,1,20.0%,1,1,20.0%,0,0.0%,0
466,9999.0,3,0,0.0%,0,0,0.0%,0,0.0%,0
467,3045.0,143,104,72.7%,104,109,76.2%,5,3.5%,0
468,4044.0,143,86,60.1%,83,91,63.6%,5,3.5%,3
469,9999.0,13,3,23.1%,1,4,30.8%,1,7.7%,2
470,4951.0,270,232,85.9%,219,232,85.9%,0,0.0%,13
471,9999.0,7,0,0.0%,0,0,0.0%,0,0.0%,0
472,8114.0,55,38,69.1%,35,39,70.9%,1,1.8%,3
473,1550.0,69,36,52.2%,34,40,58.0%,4,5.8%,2
474,6936.0,108,71,65.7%,68,73,67.6%,2,1.9%,3
475,4458.0,145,104,71.7%,100,105,72.4%,1,0.7%,4
476,7944.0,107,57,53.3%,51,62,57.9%,5,4.7%,6
477,4049.0,96,57,59.4%,53,60,62.5%,3,3.1%,4
478,9999.0,2,1,50.0%,1,1,50.0%,0,0.0%,0
479,9999.0,3,0,0.0%,0,0,0.0%,0,0.0%,0
480,254.0,430,411,95.6%,408,411,95.6%,0,0.0%,3
481,6610.0,295,226,76.6%,215,242,82.0%,16,5.4%,11
482,7546.0,34,32,94.1%,32,32,94.1%,0,0.0%,0
483,3048.0,65,49,75.4%,46,51,78.5%,2,3.1%,3
484,3495.0,404,335,82.9%,333,345,85.4%,10,2.5%,2
485,6455.0,626,549,87.7%,549,563,89.9%,14,2.2%,0
486,9999.0,74,67,90.5%,67,69,93.2%,2,2.7%,0
487,2689.0,107,95,88.8%,91,96,89.7%,1,0.9%,4
488,9999.0,2,0,0.0%,0,0,0.0%,0,0.0%,0
489,695.0,123,98,79.7%,86,105,85.4%,7,5.7%,12
490,9999.0,11,1,9.1%,1,2,18.2%,1,9.1%,0
491,9999.0,28,12,42.9%,11,12,42.9%,0,0.0%,1
492,2704.0,172,119,69.2%,111,125,72.7%,6,3.5%,8
493,7762.0,25,6,24.0%,3,7,28.0%,1,4.0%,3
494,7942.0,67,46,68.7%,37,46,68.7%,0,0.0%,9
495,1084.0,117,110,94.0%,110,111,94.9%,1,0.9%,0
496,9999.0,12,6,50.0%,6,6,50.0%,0,0.0%,0
497,4469.0,154,134,87.0%,133,134,87.0%,0,0.0%,1
498,7829.0,67,56,83.6%,54,59,88.1%,3,4.5%,2
499,7930.0,82,47,57.3%,44,47,57.3%,0,0.0%,3
500,3321.0,1,0,0.0%,0,0,0.0%,0,0.0%,0
501,6729.0,375,362,96.5%,362,362,96.5%,0,0.0%,0
502,9999.0,25,3,12.0%,3,3,12.0%,0,0.0%,0
503,6998.0,39,2,5.1%,1,2,5.1%,0,0.0%,1
504,9999.0,5,1,20.0%,1,1,20.0%,0,0.0%,0
505,6793.0,644,585,90.8%,580,587,91.1%,2,0.3%,5
506,1489.0,51,31,60.8%,31,31,60.8%,0,0.0%,0
507,6145.0,145,110,75.9%,98,116,80.0%,6,4.1%,12
508,7101.0,364,297,81.6%,296,304,83.5%,7,1.9%,1
509,4958.0,52,12,23.1%,12,12,23.1%,0,0.0%,0
510,9999.0,10,3,30.0%,3,4,40.0%,1,10.0%,0
511,5345.0,968,860,88.8%,857,873,90.2%,13,1.3%,3
512,2446.0,240,180,75.0%,171,192,80.0%,12,5.0%,9
513,9999.0,2,0,0.0%,0,0,0.0%,0,0.0%,0
514,3883.0,139,106,76.3%,105,106,76.3%,0,0.0%,1
515,9999.0,3,1,33.3%,0,1,33.3%,0,0.0%,1
516,3988.0,93,56,60.2%,56,56,60.2%,0,0.0%,0
517,3505.0,428,355,82.9%,343,356,83.2%,1,0.2%,12
518,964.0,58,33,56.9%,33,38,65.5%,5,8.6%,0
519,9999.0,1,1,100.0%,1,1,100.0%,0,0.0%,0
520,4577.0,230,162,70.4%,156,175,76.1%,13,5.7%,6
521,9999.0,7,0,0.0%,0,0,0.0%,0,0.0%,0
522,747.0,79,47,59.5%,45,55,69.6%,8,10.1%,2
523,6201.0,89,53,59.6%,43,56,62.9%,3,3.4%,10
524,9999.0,2,1,50.0%,1,1,50.0%,0,0.0%,0
525,2760.0,192,129,67.2%,115,134,69.8%,5,2.6%,14
526,9999.0,2,0,0.0%,0,0,0.0%,0,0.0%,0
527,2818.0,141,114,80.9%,113,118,83.7%,4,2.8%,1
528,3875.0,46,30,65.2%,17,30,65.2%,0,0.0%,13
529,9999.0,2,1,50.0%,1,1,50.0%,0,0.0%,0
530,4058.0,66,47,71.2%,43,47,71.2%,0,0.0%,4
531,6373.0,105,60,57.1%,54,61,58.1%,1,1.0%,6
532,6345.0,228,166,72.8%,157,170,74.6%,4,1.8%,9
533,9999.0,6,1,16.7%,1,1,16.7%,0,0.0%,0
534,53.0,93,80,86.0%,65,81,87.1%,1,1.1%,15
535,2958.0,72,52,72.2%,52,56,77.8%,4,5.6%,0
536,9999.0,4,0,0.0%,0,0,0.0%,0,0.0%,0
537,9999.0,1,0,0.0%,0,0,0.0%,0,0.0%,0
538,6745.0,134,93,69.4%,64,94,70.1%,1,0.7%,29
539,2821.0,204,159,77.9%,158,162,79.4%,3,1.5%,1
540,9999.0,1,0,0.0%,0,0,0.0%,0,0.0%,0
541,9999.0,2,0,0.0%,0,0,0.0%,0,0.0%,0
542,4717.0,396,341,86.1%,323,341,86.1%,0,0.0%,18
543,1414.0,203,138,68.0%,116,140,69.0%,2,1.0%,22
544,9999.0,6,3,50.0%,2,3,50.0%,0,0.0%,1
545,4931.0,177,90,50.8%,80,96,54.2%,6,3.4%,10
546,2449.0,82,64,78.0%,64,72,87.8%,8,9.8%,0
547,9999.0,2,0,0.0%,0,0,0.0%,0,0.0%,0
548,6318.0,153,114,74.5%,113,118,77.1%,4,2.6%,1
549,8205.0,295,84,28.5%,84,110,37.3%,26,8.8%,0
550,3877.0,34,21,61.8%,21,23,67.6%,2,5.9%,0
551,3107.0,47,28,59.6%,19,30,63.8%,2,4.3%,9
552,1406.0,368,312,84.8%,304,315,85.6%,3,0.8%,8
553,9999.0,1,0,0.0%,0,0,0.0%,0,0.0%,0
554,1420.0,274,204,74.5%,195,211,77.0%,7,2.6%,9
555,7690.0,54,29,53.7%,26,31,57.4%,2,3.7%,3
556,1094.0,150,120,80.0%,120,120,80.0%,0,0.0%,0
557,9999.0,5,0,0.0%,0,0,0.0%,0,0.0%,0
558,4734.0,137,108,78.8%,104,117,85.4%,9,6.6%,4
559,9999.0,9,1,11.1%,1,1,11.1%,0,0.0%,0
560,2766.0,213,117,54.9%,115,117,54.9%,0,0.0%,2
561,6693.0,88,68,77.3%,66,68,77.3%,0,0.0%,2
562,9999.0,7,2,28.6%,2,3,42.9%,1,14.3%,0
563,2829.0,737,636,86.3%,636,646,87.7%,10,1.4%,0
564,6439.0,160,123,76.9%,123,128,80.0%,5,3.1%,0
565,1213.0,115,74,64.3%,70,79,68.7%,5,4.3%,4
566,309.0,352,290,82.4%,284,296,84.1%,6,1.7%,6
567,2633.0,453,302,66.7%,274,305,67.3%,3,0.7%,28
568,9999.0,5,1,20.0%,1,1,20.0%,0,0.0%,0
569,1629.0,79,52,65.8%,49,52,65.8%,0,0.0%,3
570,6942.0,77,40,51.9%,37,40,51.9%,0,0.0%,3
571,9999.0,1,0,0.0%,0,0,0.0%,0,0.0%,0
572,6136.0,91,66,72.5%,64,75,82.4%,9,9.9%,2
573,9999.0,2,0,0.0%,0,0,0.0%,0,0.0%,0
574,1915.0,291,248,85.2%,245,260,89.3%,12,4.1%,3
575,1100.0,536,452,84.3%,452,459,85.6%,7,1.3%,0
576,9999.0,24,14,58.3%,14,14,58.3%,0,0.0%,0
577,2345.0,53,38,71.7%,36,41,77.4%,3,5.7%,2
578,6231.0,96,63,65.6%,52,68,70.8%,5,5.2%,11
579,9999.0,1,0,0.0%,0,0,0.0%,0,0.0%,0
580,4682.0,752,630,83.8%,628,645,85.8%,15,2.0%,2
581,9999.0,2,0,0.0%,0,0,0.0%,0,0.0%,0
582,7650.0,1513,1103,72.9%,997,1155,76.3%,52,3.4%,106
583,7821.0,22,17,77.3%,14,17,77.3%,0,0.0%,3
584,7819.0,311,185,59.5%,184,227,73.0%,42,13.5%,1
585,7687.0,212,123,58.0%,102,123,58.0%,0,0.0%,21
586,6648.0,397,347,87.4%,339,350,88.2%,3,0.8%,8
587,9999.0,1,0,0.0%,0,0,0.0%,0,0.0%,0
588,2649.0,152,84,55.3%,79,94,61.8%,10,6.6%,5
589,9999.0,1,0,0.0%,0,0,0.0%,0,0.0%,0
590,3328.0,392,344,87.8%,342,351,89.5%,7,1.8%,2
591,7770.0,47,31,66.0%,30,32,68.1%,1,2.1%,1
592,5083.0,350,324,92.6%,322,332,94.9%,8,2.3%,2
593,7587.0,111,83,74.8%,83,90,81.1%,7,6.3%,0
594,7904.0,116,101,87.1%,99,103,88.8%,2,1.7%,2
595,8039.0,106,85,80.2%,85,89,84.0%,4,3.8%,0
596,3847.0,242,156,64.5%,146,164,67.8%,8,3.3%,10
597,7070.0,137,131,95.6%,131,134,97.8%,3,2.2%,0
598,3840.0,177,131,74.0%,126,137,77.4%,6,3.4%,5
599,4728.0,82,67,81.7%,62,69,84.1%,2,2.4%,5
600,7023.0,176,170,96.6%,169,171,97.2%,1,0.6%,1
601,3848.0,523,421,80.5%,420,421,80.5%,0,0.0%,1
602,7781.0,78,66,84.6%,65,68,87.2%,2,2.6%,1
603,7905.0,91,81,89.0%,77,82,90.1%,1,1.1%,4
604,6996.0,144,129,89.6%,128,129,89.6%,0,0.0%,1
605,3841.0,118,82,69.5%,81,87,73.7%,5,4.2%,1
606,3787.0,40,3,7.5%,3,3,7.5%,0,0.0%,0
607,3849.0,282,162,57.4%,159,178,63.1%,16,5.7%,3
608,3816.0,251,131,52.2%,130,135,53.8%,4,1.6%,1
609,7240.0,21,17,81.0%,13,17,81.0%,0,0.0%,4
610,3850.0,307,131,42.7%,127,145,47.2%,14,4.6%,4
611,3851.0,118,77,65.3%,75,85,72.0%,8,6.8%,2
612,6822.0,119,107,89.9%,106,108,90.8%,1,0.8%,1
613,3818.0,101,80,79.2%,72,87,86.1%,7,6.9%,8
614,7664.0,47,34,72.3%,33,34,72.3%,0,0.0%,1
615,3852.0,168,130,77.4%,120,139,82.7%,9,5.4%,10
616,3843.0,196,163,83.2%,163,163,83.2%,0,0.0%,0
617,7852.0,109,62,56.9%,62,99,90.8%,37,33.9%,0
618,7855.0,100,69,69.0%,67,79,79.0%,10,10.0%,2
619,7851.0,79,21,26.6%,20,23,29.1%,2,2.5%,1
620,6675.0,180,133,73.9%,133,147,81.7%,14,7.8%,0
621,7810.0,53,45,84.9%,41,45,84.9%,0,0.0%,4
622,7811.0,61,58,95.1%,58,59,96.7%,1,1.6%,0
623,3845.0,358,236,65.9%,232,256,71.5%,20,5.6%,4
624,3842.0,149,112,75.2%,107,128,85.9%,16,10.7%,5
625,3808.0,101,101,100.0%,101,101,100.0%,0,0.0%,0
626,7815.0,53,47,88.7%,46,47,88.7%,0,0.0%,1
627,3855.0,617,90,14.6%,85,92,14.9%,2,0.3%,5
628,3857.0,289,224,77.5%,221,249,86.2%,25,8.7%,3
629,6548.0,77,67,87.0%,67,67,87.0%,0,0.0%,0
630,7808.0,47,44,93.6%,42,46,97.9%,2,4.3%,2
631,7782.0,71,69,97.2%,69,71,100.0%,2,2.8%,0
632,7780.0,75,64,85.3%,63,67,89.3%,3,4.0%,1
633,9999.0,1117,260,23.3%,252,311,27.8%,51,4.6%,8
634,7814.0,41,33,80.5%,33,38,92.7%,5,12.2%,0
635,8120.0,45,0,0.0%,0,0,0.0%,0,0.0%,0
636,8121.0,61,37,60.7%,37,37,60.7%,0,0.0%,0
637,7850.0,43,30,69.8%,30,35,81.4%,5,11.6%,0
638,7812.0,45,42,93.3%,42,42,93.3%,0,0.0%,0
639,7813.0,85,51,60.0%,49,56,65.9%,5,5.9%,2
640,6522.0,51,43,84.3%,41,45,88.2%,2,3.9%,2
641,3844.0,127,110,86.6%,105,118,92.9%,8,6.3%,5
642,3861.0,109,85,78.0%,78,85,78.0%,0,0.0%,7
643,7245.0,101,67,66.3%,61,81,80.2%,14,13.9%,6
644,7903.0,73,63,86.3%,58,65,89.0%,2,2.7%,5
645,7906.0,122,110,90.2%,110,111,91.0%,1,0.8%,0
646,3859.0,189,115,60.8%,108,128,67.7%,13,6.9%,7
647,7255.0,79,49,62.0%,49,77,97.5%,28,35.4%,0
648,7072.0,173,108,62.4%,98,117,67.6%,9,5.2%,10
649,6523.0,146,2,1.4%,2,2,1.4%,0,0.0%,0
650,7252.0,70,53,75.7%,50,53,75.7%,0,0.0%,3
651,6527.0,465,381,81.9%,364,388,83.4%,7,1.5%,17
652,3860.0,133,85,63.9%,83,90,67.7%,5,3.8%,2
653,3728.0,17,0,0.0%,0,0,0.0%,0,0.0%,0
654,7737.0,128,0,0.0%,0,0,0.0%,0,0.0%,0
655,1560.0,136,85,62.5%,75,85,62.5%,0,0.0%,10
656,1426.0,250,214,85.6%,211,219,87.6%,5,2.0%,3
657,9999.0,17,0,0.0%,0,0,0.0%,0,0.0%,0
658,3910.0,134,70,52.2%,62,80,59.7%,10,7.5%,8
659,315.0,367,324,88.3%,324,331,90.2%,7,1.9%,0
660,9999.0,5,0,0.0%,0,0,0.0%,0,0.0%,0
661,8203.0,86,0,0.0%,0,0,0.0%,0,0.0%,0
662,409.0,322,0,0.0%,0,0,0.0%,0,0.0%,0
663,6915.0,257,0,0.0%,0,0,0.0%,0,0.0%,0
664,8106.0,130,0,0.0%,0,0,0.0%,0,0.0%,0
665,412.0,185,0,0.0%,0,0,0.0%,0,0.0%,0
666,6811.0,20,0,0.0%,0,0,0.0%,0,0.0%,0
667,415.0,89,0,0.0%,0,0,0.0%,0,0.0%,0
668,8110.0,138,0,0.0%,0,0,0.0%,0,0.0%,0
669,8105.0,103,0,0.0%,0,0,0.0%,0,0.0%,0
670,6047.0,13,0,0.0%,0,0,0.0%,0,0.0%,0
671,422.0,85,0,0.0%,0,0,0.0%,0,0.0%,0
672,416.0,146,0,0.0%,0,0,0.0%,0,0.0%,0
673,6664.0,3,0,0.0%,0,0,0.0%,0,0.0%,0
674,9999.0,25,0,0.0%,0,0,0.0%,0,0.0%,0
675,6873.0,1,0,0.0%,0,0,0.0%,0,0.0%,0
676,9999.0,11,1,9.1%,1,1,9.1%,0,0.0%,0
677,5058.0,290,238,82.1%,228,244,84.1%,6,2.1%,10
678,3210.0,475,368,77.5%,360,373,78.5%,5,1.1%,8
679,9999.0,12,0,0.0%,0,0,0.0%,0,0.0%,0
680,9999.0,2,0,0.0%,0,0,0.0%,0,0.0%,0
681,435.0,320,247,77.2%,243,254,79.4%,7,2.2%,4
682,7771.0,4,2,50.0%,2,2,50.0%,0,0.0%,0
683,3216.0,344,258,75.0%,251,259,75.3%,1,0.3%,7
684,9999.0,62,16,25.8%,16,17,27.4%,1,1.6%,0
685,7738.0,389,274,70.4%,271,282,72.5%,8,2.1%,3
686,3111.0,90,57,63.3%,57,61,67.8%,4,4.4%,0
687,1270.0,66,34,51.5%,31,37,56.1%,3,4.5%,3
688,9999.0,5,0,0.0%,0,0,0.0%,0,0.0%,0
689,3338.0,301,213,70.8%,209,232,77.1%,19,6.3%,4
690,9999.0,13,2,15.4%,1,2,15.4%,0,0.0%,1
691,3348.0,160,116,72.5%,109,133,83.1%,17,10.6%,7
692,3924.0,270,163,60.4%,117,164,60.7%,1,0.4%,46
693,7540.0,134,97,72.4%,97,98,73.1%,1,0.7%,0
694,8129.0,1,0,0.0%,0,0,0.0%,0,0.0%,0
695,7772.0,42,33,78.6%,32,33,78.6%,0,0.0%,1
696,6165.0,164,110,67.1%,94,119,72.6%,9,5.5%,16
697,2350.0,63,29,46.0%,24,34,54.0%,5,7.9%,5
698,448.0,176,152,86.4%,152,156,88.6%,4,2.3%,0
699,9999.0,6,3,50.0%,3,3,50.0%,0,0.0%,0
700,9999.0,33,6,18.2%,6,8,24.2%,2,6.1%,0
701,1128.0,352,319,90.6%,314,322,91.5%,3,0.9%,5
702,1921.0,295,273,92.5%,273,273,92.5%,0,0.0%,0
703,9999.0,1,0,0.0%,0,0,0.0%,0,0.0%,0
704,8116.0,780,486,62.3%,470,494,63.3%,8,1.0%,16
705,9999.0,2,0,0.0%,0,0,0.0%,0,0.0%,0
706,4598.0,414,274,66.2%,246,287,69.3%,13,3.1%,28
707,1495.0,97,58,59.8%,58,62,63.9%,4,4.1%,0
708,9999.0,1,0,0.0%,0,0,0.0%,0,0.0%,0
709,7636.0,40,38,95.0%,38,39,97.5%,1,2.5%,0
710,3165.0,106,73,68.9%,55,82,77.4%,9,8.5%,18
711,7941.0,127,98,77.2%,96,102,80.3%,4,3.1%,2
712,1989.0,96,56,58.3%,42,56,58.3%,0,0.0%,14
713,1934.0,456,374,82.0%,360,385,84.4%,11,2.4%,14
714,9999.0,7,0,0.0%,0,0,0.0%,0,0.0%,0
715,9999.0,1,0,0.0%,0,0,0.0%,0,0.0%,0
716,7019.0,249,206,82.7%,199,211,84.7%,5,2.0%,7
717,700.0,139,97,69.8%,94,97,69.8%,0,0.0%,3
718,2496.0,123,87,70.7%,85,93,75.6%,6,4.9%,2
719,6928.0,95,79,83.2%,79,81,85.3%,2,2.1%,0
720,7629.0,40,37,92.5%,33,39,97.5%,2,5.0%,4
721,8000.0,65,29,44.6%,29,38,58.5%,9,13.8%,0
722,6210.0,51,31,60.8%,31,31,60.8%,0,0.0%,0
723,9999.0,1,0,0.0%,0,0,0.0%,0,0.0%,0
724,1942.0,321,294,91.6%,292,301,93.8%,7,2.2%,2
725,9999.0,8,0,0.0%,0,1,12.5%,1,12.5%,0
726,5169.0,171,109,63.7%,103,120,70.2%,11,6.4%,6
727,2833.0,125,106,84.8%,106,108,86.4%,2,1.6%,0
728,4002.0,30,15,50.0%,14,17,56.7%,2,6.7%,1
729,9999.0,1,0,0.0%,0,0,0.0%,0,0.0%,0
730,5352.0,179,157,87.7%,156,157,87.7%,0,0.0%,1
731,965.0,72,55,76.4%,55,57,79.2%,2,2.8%,0
732,5264.0,95,62,65.3%,60,70,73.7%,8,8.4%,2
733,864.0,148,106,71.6%,96,110,74.3%,4,2.7%,10
734,6413.0,377,280,74.3%,275,306,81.2%,26,6.9%,5
735,9999.0,11,0,0.0%,0,0,0.0%,0,0.0%,0
736,2489.0,213,151,70.9%,149,158,74.2%,7,3.3%,2
737,3969.0,201,141,70.1%,139,147,73.1%,6,3.0%,2
738,9999.0,4,0,0.0%,0,0,0.0%,0,0.0%,0
739,1183.0,530,457,86.2%,444,467,88.1%,10,1.9%,13
740,4006.0,48,24,50.0%,24,26,54.2%,2,4.2%,0
741,460.0,469,387,82.5%,378,395,84.2%,8,1.7%,9
742,9999.0,8,0,0.0%,0,0,0.0%,0,0.0%,0
743,7893.0,199,107,53.8%,103,107,53.8%,0,0.0%,4
744,9999.0,6,0,0.0%,0,0,0.0%,0,0.0%,0
745,6800.0,31,18,58.1%,17,18,58.1%,0,0.0%,1
746,8093.0,133,97,72.9%,83,97,72.9%,0,0.0%,14
747,3124.0,96,77,80.2%,77,77,80.2%,0,0.0%,0
748,3940.0,80,54,67.5%,54,58,72.5%,4,5.0%,0
749,9999.0,2,0,0.0%,0,0,0.0%,0,0.0%,0
750,2708.0,90,68,75.6%,66,74,82.2%,6,6.7%,2
751,3569.0,193,107,55.4%,101,108,56.0%,1,0.5%,6
752,9999.0,1,0,0.0%,0,0,0.0%,0,0.0%,0
753,5221.0,289,184,63.7%,184,191,66.1%,7,2.4%,0
754,1172.0,189,136,72.0%,136,143,75.7%,7,3.7%,0
755,3117.0,62,40,64.5%,33,44,71.0%,4,6.5%,7
756,2658.0,274,164,59.9%,153,168,61.3%,4,1.5%,11
757,4015.0,162,102,63.0%,102,107,66.0%,5,3.1%,0
758,9999.0,2,0,0.0%,0,0,0.0%,0,0.0%,0
759,9999.0,1,1,100.0%,1,1,100.0%,0,0.0%,0
760,3354.0,566,440,77.7%,440,441,77.9%,1,0.2%,0
761,440.0,150,97,64.7%,89,100,66.7%,3,2.0%,8
762,1177.0,222,174,78.4%,172,180,81.1%,6,2.7%,2
763,4602.0,203,157,77.3%,140,157,77.3%,0,0.0%,17
764,9999.0,12,3,25.0%,2,3,25.0%,0,0.0%,1
765,9999.0,2,0,0.0%,0,0,0.0%,0,0.0%,0
766,470.0,145,125,86.2%,121,127,87.6%,2,1.4%,4
767,6328.0,160,123,76.9%,121,125,78.1%,2,1.3%,2
768,9999.0,1,0,0.0%,0,0,0.0%,0,0.0%,0
769,9999.0,1,0,0.0%,0,0,0.0%,0,0.0%,0
770,467.0,182,156,85.7%,156,156,85.7%,0,0.0%,0
771,9999.0,1,0,0.0%,0,0,0.0%,0,0.0%,0
772,714.0,104,83,79.8%,83,83,79.8%,0,0.0%,0
773,9999.0,1,0,0.0%,0,0,0.0%,0,0.0%,0
774,4608.0,324,230,71.0%,216,248,76.5%,18,5.6%,14
775,3056.0,92,70,76.1%,69,71,77.2%,1,1.1%,1
776,6516.0,250,181,72.4%,178,188,75.2%,7,2.8%,3
777,9999.0,4,0,0.0%,0,0,0.0%,0,0.0%,0
778,2284.0,48,25,52.1%,24,27,56.3%,2,4.2%,1
779,9999.0,1,0,0.0%,0,0,0.0%,0,0.0%,0
780,1627.0,94,75,79.8%,75,76,80.9%,1,1.1%,0
781,2253.0,67,28,41.8%,27,31,46.3%,3,4.5%,1
782,2313.0,92,55,59.8%,52,56,60.9%,1,1.1%,3
783,9999.0,7,1,14.3%,1,1,14.3%,0,0.0%,0
784,2839.0,237,215,90.7%,214,220,92.8%,5,2.1%,1
785,4064.0,34,16,47.1%,16,17,50.0%,1,2.9%,0
786,4068.0,54,27,50.0%,26,30,55.6%,3,5.6%,1
787,4071.0,45,26,57.8%,23,26,57.8%,0,0.0%,3
788,9999.0,3,1,33.3%,1,1,33.3%,0,0.0%,0
789,4614.0,248,169,68.1%,161,189,76.2%,20,8.1%,8
790,9999.0,3,1,33.3%,1,1,33.3%,0,0.0%,0
791,6191.0,164,119,72.6%,119,131,79.9%,12,7.3%,0
792,7648.0,5,1,20.0%,0,1,20.0%,0,0.0%,1
793,941.0,129,79,61.2%,75,83,64.3%,4,3.1%,4
794,9999.0,1,0,0.0%,0,0,0.0%,0,0.0%,0
795,9999.0,17,1,5.9%,1,2,11.8%,1,5.9%,0
796,4623.0,259,173,66.8%,162,177,68.3%,4,1.5%,11
797,1950.0,301,275,91.4%,275,279,92.7%,4,1.3%,0
798,9999.0,2,0,0.0%,0,0,0.0%,0,0.0%,0
799,9999.0,2,0,0.0%,0,0,0.0%,0,0.0%,0
800,3376.0,162,146,90.1%,146,148,91.4%,2,1.2%,0
801,9999.0,1,0,0.0%,0,0,0.0%,0,0.0%,0
802,3367.0,525,448,85.3%,445,457,87.0%,9,1.7%,3
803,1364.0,579,505,87.2%,488,507,87.6%,2,0.3%,17
804,9999.0,16,0,0.0%,0,0,0.0%,0,0.0%,0
805,196.0,152,96,63.2%,90,105,69.1%,9,5.9%,6
806,1801.0,81,48,59.3%,45,57,70.4%,9,11.1%,3
807,477.0,92,62,67.4%,62,63,68.5%,1,1.1%,0
808,9999.0,6,2,33.3%,2,2,33.3%,0,0.0%,0
809,9999.0,1,0,0.0%,0,0,0.0%,0,0.0%,0
810,3224.0,472,350,74.2%,347,352,74.6%,2,0.4%,3
811,7635.0,15,1,6.7%,1,1,6.7%,0,0.0%,0
812,4030.0,56,33,58.9%,33,34,60.7%,1,1.8%,0
813,7567.0,40,20,50.0%,16,26,65.0%,6,15.0%,4
814,4054.0,62,36,58.1%,33,36,58.1%,0,0.0%,3
815,9999.0,2,1,50.0%,0,1,50.0%,0,0.0%,1
816,1806.0,243,204,84.0%,203,210,86.4%,6,2.5%,1
817,3589.0,145,96,66.2%,94,96,66.2%,0,0.0%,2
818,5070.0,146,131,89.7%,128,133,91.1%,2,1.4%,3
819,7833.0,13,9,69.2%,9,9,69.2%,0,0.0%,0
820,1668.0,126,75,59.5%,64,81,64.3%,6,4.8%,11
821,5208.0,141,81,57.4%,75,85,60.3%,4,2.8%,6
822,1423.0,498,487,97.8%,487,488,98.0%,1,0.2%,0
823,9999.0,21,13,61.9%,11,13,61.9%,0,0.0%,2
824,9999.0,1,0,0.0%,0,0,0.0%,0,0.0%,0
825,6012.0,231,180,77.9%,168,185,80.1%,5,2.2%,12
826,3957.0,56,41,73.2%,29,42,75.0%,1,1.8%,12
827,1000.0,126,74,58.7%,66,76,60.3%,2,1.6%,8
828,7983.0,46,40,87.0%,40,40,87.0%,0,0.0%,0
829,9999.0,2,0,0.0%,0,0,0.0%,0,0.0%,0
830,4670.0,134,82,61.2%,82,87,64.9%,5,3.7%,0
831,5271.0,218,152,69.7%,148,152,69.7%,0,0.0%,4
832,6216.0,29,10,34.5%,10,15,51.7%,5,17.2%,0
833,9999.0,2,0,0.0%,0,0,0.0%,0,0.0%,0
834,6280.0,170,98,57.6%,89,102,60.0%,4,2.4%,9
835,753.0,75,38,50.7%,29,40,53.3%,2,2.7%,9
836,873.0,208,165,79.3%,158,167,80.3%,2,1.0%,7
837,949.0,139,95,68.3%,85,107,77.0%,12,8.6%,10
838,2712.0,49,43,87.8%,39,45,91.8%,2,4.1%,4
839,9999.0,10,4,40.0%,4,5,50.0%,1,10.0%,0
840,9999.0,1,0,0.0%,0,0,0.0%,0,0.0%,0
841,2075.0,75,35,46.7%,34,41,54.7%,6,8.0%,1
842,1501.0,47,26,55.3%,24,26,55.3%,0,0.0%,2
843,9999.0,11,0,0.0%,0,0,0.0%,0,0.0%,0
844,2184.0,198,130,65.7%,117,132,66.7%,2,1.0%,13
845,1443.0,366,340,92.9%,340,343,93.7%,3,0.8%,0
846,9999.0,6,0,0.0%,0,0,0.0%,0,0.0%,0
847,2358.0,89,57,64.0%,55,61,68.5%,4,4.5%,2
848,9999.0,2,1,50.0%,0,1,50.0%,0,0.0%,1
849,8195.0,119,78,65.5%,78,87,73.1%,9,7.6%,0
850,21.0,134,108,80.6%,104,112,83.6%,4,3.0%,4
851,9999.0,28,0,0.0%,0,0,0.0%,0,0.0%,0
852,1972.0,841,606,72.1%,583,632,75.1%,26,3.1%,23
853,6340.0,86,59,68.6%,39,59,68.6%,0,0.0%,20
854,5078.0,375,358,95.5%,358,358,95.5%,0,0.0%,0
855,9999.0,4,0,0.0%,0,0,0.0%,0,0.0%,0
856,9999.0,14,3,21.4%,2,3,21.4%,0,0.0%,1
857,3395.0,285,245,86.0%,241,250,87.7%,5,1.8%,4
858,3401.0,236,181,76.7%,178,181,76.7%,0,0.0%,3
859,9999.0,13,2,15.4%,2,2,15.4%,0,0.0%,0
860,5081.0,232,180,77.6%,177,180,77.6%,0,0.0%,3
861,9999.0,3,0,0.0%,0,0,0.0%,0,0.0%,0
862,492.0,367,349,95.1%,349,355,96.7%,6,1.6%,0
863,7562.0,32,30,93.8%,30,30,93.8%,0,0.0%,0
864,4126.0,55,24,43.6%,19,31,56.4%,7,12.7%,5
865,6775.0,184,152,82.6%,143,155,84.2%,3,1.6%,9
866,4310.0,337,208,61.7%,187,208,61.7%,0,0.0%,21
867,9999.0,2,0,0.0%,0,0,0.0%,0,0.0%,0
868,5287.0,311,290,93.2%,290,290,93.2%,0,0.0%,0
869,4143.0,62,48,77.4%,47,51,82.3%,3,4.8%,1
870,4146.0,51,31,60.8%,31,31,60.8%,0,0.0%,0
871,4149.0,167,122,73.1%,114,123,73.7%,1,0.6%,8
872,4135.0,75,34,45.3%,31,41,54.7%,7,9.3%,3
873,5103.0,118,72,61.0%,72,82,69.5%,10,8.5%,0
874,2663.0,341,271,79.5%,264,275,80.6%,4,1.2%,7
875,4286.0,96,68,70.8%,62,68,70.8%,0,0.0%,6
876,9999.0,6,0,0.0%,0,0,0.0%,0,0.0%,0
877,6148.0,120,69,57.5%,60,81,67.5%,12,10.0%,9
878,9999.0,3,1,33.3%,1,1,33.3%,0,0.0%,0
879,4295.0,253,170,67.2%,166,186,73.5%,16,6.3%,4
880,9999.0,18,7,38.9%,7,7,38.9%,0,0.0%,0
881,2243.0,264,154,58.3%,150,161,61.0%,7,2.7%,4
882,1327.0,48,34,70.8%,33,35,72.9%,1,2.1%,1
883,4080.0,106,63,59.4%,63,65,61.3%,2,1.9%,0
884,509.0,233,201,86.3%,190,209,89.7%,8,3.4%,11
885,1566.0,93,62,66.7%,52,62,66.7%,0,0.0%,10
886,9999.0,3,0,0.0%,0,0,0.0%,0,0.0%,0
887,7894.0,342,305,89.2%,303,311,90.9%,6,1.8%,2
888,6734.0,327,284,86.9%,284,291,89.0%,7,2.1%,0
889,1453.0,329,295,89.7%,294,296,90.0%,1,0.3%,1
890,7136.0,59,38,64.4%,38,38,64.4%,0,0.0%,0
891,523.0,230,203,88.3%,194,206,89.6%,3,1.3%,9
892,9999.0,11,2,18.2%,2,2,18.2%,0,0.0%,0
893,6129.0,63,48,76.2%,43,51,81.0%,3,4.8%,5
894,536.0,257,195,75.9%,179,204,79.4%,9,3.5%,16
895,9999.0,21,0,0.0%,0,0,0.0%,0,0.0%,0
896,9999.0,2,1,50.0%,1,1,50.0%,0,0.0%,0
897,3596.0,202,133,65.8%,128,137,67.8%,4,2.0%,5
898,1732.0,293,222,75.8%,220,223,76.1%,1,0.3%,2
899,4704.0,300,216,72.0%,216,219,73.0%,3,1.0%,0
900,5059.0,107,25,23.4%,25,25,23.4%,0,0.0%,0
901,6705.0,206,165,80.1%,159,168,81.6%,3,1.5%,6
902,9999.0,36,15,41.7%,15,26,72.2%,11,30.6%,0
903,719.0,57,44,77.2%,39,46,80.7%,2,3.5%,5
904,9999.0,1,0,0.0%,0,0,0.0%,0,0.0%,0
905,6704.0,140,95,67.9%,93,103,73.6%,8,5.7%,2
906,9999.0,12,0,0.0%,0,0,0.0%,0,0.0%,0
907,1293.0,146,116,79.5%,116,117,80.1%,1,0.7%,0
908,2848.0,369,283,76.7%,283,292,79.1%,9,2.4%,0
909,9999.0,1,0,0.0%,0,0,0.0%,0,0.0%,0
910,3009.0,142,0,0.0%,0,0,0.0%,0,0.0%,0
911,3008.0,118,0,0.0%,0,0,0.0%,0,0.0%,0
912,3007.0,255,0,0.0%,0,0,0.0%,0,0.0%,0
913,9999.0,25,0,0.0%,0,0,0.0%,0,0.0%,0
914,9999.0,2,0,0.0%,0,0,0.0%,0,0.0%,0
915,555.0,61,2,3.3%,1,2,3.3%,0,0.0%,1
916,1892.0,333,133,39.9%,133,141,42.3%,8,2.4%,0
917,9999.0,6,0,0.0%,0,0,0.0%,0,0.0%,0
918,3914.0,70,49,70.0%,43,54,77.1%,5,7.1%,6
919,951.0,41,22,53.7%,16,27,65.9%,5,12.2%,6
920,9999.0,1,0,0.0%,0,0,0.0%,0,0.0%,0
921,6368.0,415,240,57.8%,239,242,58.3%,2,0.5%,1
922,2721.0,88,69,78.4%,65,75,85.2%,6,6.8%,4
923,9999.0,3,1,33.3%,1,1,33.3%,0,0.0%,0
924,9999.0,1,0,0.0%,0,0,0.0%,0,0.0%,0
925,6980.0,434,317,73.0%,294,322,74.2%,5,1.2%,23
926,3522.0,143,111,77.6%,108,111,77.6%,0,0.0%,3
927,9999.0,3,1,33.3%,1,1,33.3%,0,0.0%,0
928,4026.0,94,72,76.6%,69,76,80.9%,4,4.3%,3
929,9999.0,15,1,6.7%,1,4,26.7%,3,20.0%,0
930,3247.0,365,336,92.1%,336,342,93.7%,6,1.6%,0
931,107.0,313,226,72.2%,214,234,74.8%,8,2.6%,12
932,9999.0,1,0,0.0%,0,0,0.0%,0,0.0%,0
933,1005.0,82,52,63.4%,52,53,64.6%,1,1.2%,0
934,6390.0,199,175,87.9%,175,177,88.9%,2,1.0%,0
935,9999.0,16,0,0.0%,0,0,0.0%,0,0.0%,0
936,6391.0,323,247,76.5%,245,260,80.5%,13,4.0%,2
937,887.0,165,136,82.4%,128,140,84.8%,4,2.4%,8
938,7945.0,7,3,42.9%,3,3,42.9%,0,0.0%,0
939,4647.0,218,154,70.6%,154,159,72.9%,5,2.3%,0
940,9999.0,9,1,11.1%,1,2,22.2%,1,11.1%,0
941,5168.0,292,134,45.9%,125,140,47.9%,6,2.1%,9
942,9999.0,10,3,30.0%,3,4,40.0%,1,10.0%,0
943,4658.0,193,172,89.1%,172,172,89.1%,0,0.0%,0
944,4735.0,150,102,68.0%,102,107,71.3%,5,3.3%,0
945,7513.0,163,66,40.5%,64,88,54.0%,22,13.5%,2
946,,,,,,,,,,
947,,"131,733","94,005",71.4%,"90,416","97,304",73.9%,"3,299",2.5%,"3,589"
948,,,,,,,,,,
949,,,,,,,,,,
950,,,,,,,,,,
951,,,,,,,,,,
952,,,,,,,,,,
953,,,,,,,,,,
954,,,,,,,,,,
955,,,,,,,,,,
956,,,,,,,,,,
957,,,,,,,,,,
958,,,,,,,,,,
959,,,,,,,,,,
960,,,,,,,,,,
961,,,,,,,,,,
962,,,,,,,,,,
963,,,,,,,,,,
964,,,,,,,,,,
965,,,,,,,,,,
966,,,,,,,,,,
967,,,,,,,,,,
968,,,,,,,,,,
969,,,,,,,,,,
970,,,,,,,,,,
971,,,,,,,,,,
972,,,,,,,,,,
973,,,,,,,,,,
974,,,,,,,,,,
975,,,,,,,,,,
976,,,,,,,,,,
977,,,,,,,,,,
978,,,,,,,,,,
979,,,,,,,,,,
980,,,,,,,,,,
981,,,,,,,,,,
982,,,,,,,,,,
983,,,,,,,,,,
984,,,,,,,,,,
985,,,,,,,,,,
986,,,,,,,,,,
987,,,,,,,,,,
988,,,,,,,,,,
989,,,,,,,,,,
990,,,,,,,,,,
991,,,,,,,,,,
992,,,,,,,,,,
993,,,,,,,,,,
994,,,,,,,,,,
995,,,,,,,,,,
996,,,,,,,,,,
997,,,,,,,,,,
998,,,,,,,,,,
999,,,,,,,,,,
1000,,,,,,,,,,
1001,,,,,,,,,,
1002,,,,,,,,,,
1003,,,,,,,,,,
1004,,,,,,,,,,
1005,,,,,,,,,,
1006,,,,,,,,,,
1007,,,,,,,,,,
1008,,,,,,,,,,
1009,,,,,,,,,,
1010,,,,,,,,,,
1011,,,,,,,,,,
1012,,,,,,,,,,
1013,,,,,,,,,,
1014,,,,,,,,,,
1015,,,,,,,,,,
1016,,,,,,,,,,
1017,,,,,,,,,,
1018,,,,,,,,,,
1019,,,,,,,,,,
1020,,,,,,,,,,
1021,,,,,,,,,,
1022,,,,,,,,,,
1023,,,,,,,,,,
1024,,,,,,,,,,
1025,,,,,,,,,,
1026,,,,,,,,,,
1027,,,,,,,,,,
1028,,,,,,,,,,
1029,,,,,,,,,,
1030,,,,,,,,,,
1031,,,,,,,,,,
1032,,,,,,,,,,
1033,,,,,,,,,,
1034,,,,,,,,,,
1035,,,,,,,,,,
1036,,,,,,,,,,
1037,,,,,,,,,,
1038,,,,,,,,,,
1039,,,,,,,,,,
1040,,,,,,,,,,
1041,,,,,,,,,,
1042,,,,,,,,,,
1043,,,,,,,,,,
1044,,,,,,,,,,
1045,,,,,,,,,,
1046,,,,,,,,,,
1047,,,,,,,,,,
1048,,,,,,,,,,
1049,,,,,,,,,,
