,school number,graduate count,college bound,total college bound %,2- or 4-year college or university,2- or 4-year university %,total postsecondary bound,total postsecondary bound %,non-degree-granting postsecondary school,non-degree-granting postsecondary school %,specialized associate degree granting institution,specialized associate degree granting institution %
0,3.0,147,99,67.35%,99,67.35%,105,71.43%,6,4.08%,0,0.00%
1,9999.0,3,0,0.00%,0,0.00%,0,0.00%,0,0.00%,0,0.00%
2,17.0,267,176,65.92%,167,62.55%,186,69.66%,10,3.75%,9,3.37%
3,6269.0,89,73,82.02%,73,82.02%,75,84.27%,2,2.25%,0,0.00%
4,9999.0,1,0,0.00%,0,0.00%,0,0.00%,0,0.00%,0,0.00%
5,6271.0,263,201,76.43%,186,70.72%,205,77.95%,4,1.52%,15,5.70%
6,9999.0,5,0,0.00%,0,0.00%,0,0.00%,0,0.00%,0,0.00%
7,14.0,155,105,67.74%,92,59.35%,107,69.03%,2,1.29%,13,8.39%
8,9999.0,6,0,0.00%,0,0.00%,0,0.00%,0,0.00%,0,0.00%
9,21.0,114,74,64.91%,69,60.53%,75,65.79%,1,0.88%,5,4.39%
10,9999.0,7,0,0.00%,0,0.00%,1,14.29%,1,14.29%,0,0.00%
11,7727.0,132,95,71.97%,91,68.94%,98,74.24%,3,2.27%,4,3.03%
12,7846.0,15,7,46.67%,7,46.67%,10,66.67%,3,20.00%,0,0.00%
13,7562.0,41,37,90.24%,35,85.37%,39,95.12%,2,4.88%,2,4.88%
14,8308.0,83,0,0.00%,0,0.00%,0,0.00%,0,0.00%,0,0.00%
15,409.0,333,199,59.76%,198,59.46%,203,60.96%,4,1.20%,1,0.30%
16,412.0,148,114,77.03%,101,68.24%,118,79.73%,4,2.70%,13,8.78%
17,416.0,81,56,69.14%,52,64.20%,59,72.84%,3,3.70%,4,4.94%
18,6047.0,8,0,0.00%,0,0.00%,0,0.00%,0,0.00%,0,0.00%
19,6811.0,7,0,0.00%,0,0.00%,0,0.00%,0,0.00%,0,0.00%
20,6915.0,269,163,60.59%,157,58.36%,178,66.17%,15,5.58%,6,2.23%
21,8105.0,114,0,0.00%,0,0.00%,0,0.00%,0,0.00%,0,0.00%
22,8106.0,134,2,1.49%,2,1.49%,2,1.49%,0,0.00%,0,0.00%
23,8107.0,69,0,0.00%,0,0.00%,0,0.00%,0,0.00%,0,0.00%
24,8110.0,72,3,4.17%,3,4.17%,4,5.56%,1,1.39%,0,0.00%
25,8203.0,75,5,6.67%,5,6.67%,7,9.33%,2,2.67%,0,0.00%
26,8300.0,29,8,27.59%,8,27.59%,8,27.59%,0,0.00%,0,0.00%
27,9999.0,11,1,9.09%,1,9.09%,1,9.09%,0,0.00%,0,0.00%
28,7772.0,39,33,84.62%,33,84.62%,33,84.62%,0,0.00%,0,0.00%
29,29.0,86,62,72.09%,57,66.28%,65,75.58%,3,3.49%,5,5.81%
30,9999.0,1,0,0.00%,0,0.00%,0,0.00%,0,0.00%,0,0.00%
31,5199.0,98,86,87.76%,86,87.76%,86,87.76%,0,0.00%,0,0.00%
32,9999.0,1,0,0.00%,0,0.00%,0,0.00%,0,0.00%,0,0.00%
33,315.0,363,334,92.01%,334,92.01%,341,93.94%,7,1.93%,0,0.00%
34,9999.0,1,0,0.00%,0,0.00%,0,0.00%,0,0.00%,0,0.00%
35,50.0,329,272,82.67%,268,81.46%,282,85.71%,10,3.04%,4,1.22%
36,9999.0,2,0,0.00%,0,0.00%,0,0.00%,0,0.00%,0,0.00%
37,62.0,416,338,81.25%,338,81.25%,338,81.25%,0,0.00%,0,0.00%
38,9999.0,5,0,0.00%,0,0.00%,0,0.00%,0,0.00%,0,0.00%
39,70.0,109,94,86.24%,87,79.82%,96,88.07%,2,1.83%,7,6.42%
40,79.0,104,72,69.23%,65,62.50%,75,72.12%,3,2.88%,7,6.73%
41,6706.0,267,215,80.52%,215,80.52%,215,80.52%,0,0.00%,0,0.00%
42,9999.0,1,0,0.00%,0,0.00%,1,100.00%,1,100.00%,0,0.00%
43,8094.0,51,34,66.67%,28,54.90%,34,66.67%,0,0.00%,6,11.76%
44,9999.0,1,0,0.00%,0,0.00%,0,0.00%,0,0.00%,0,0.00%
45,8087.0,44,35,79.55%,35,79.55%,40,90.91%,5,11.36%,0,0.00%
46,513.0,160,122,76.25%,122,76.25%,138,86.25%,16,10.00%,0,0.00%
47,9999.0,4,1,25.00%,1,25.00%,1,25.00%,0,0.00%,0,0.00%
48,8340.0,103,79,76.70%,77,74.76%,79,76.70%,0,0.00%,2,1.94%
49,9999.0,1,0,0.00%,0,0.00%,0,0.00%,0,0.00%,0,0.00%
50,144.0,195,146,74.87%,137,70.26%,147,75.38%,1,0.51%,9,4.62%
51,7648.0,10,1,10.00%,1,10.00%,1,10.00%,0,0.00%,0,0.00%
52,156.0,346,303,87.57%,302,87.28%,305,88.15%,2,0.58%,1,0.29%
53,9999.0,1,1,100.00%,1,100.00%,1,100.00%,0,0.00%,0,0.00%
54,170.0,269,222,82.53%,216,80.30%,226,84.01%,4,1.49%,6,2.23%
55,9999.0,7,0,0.00%,0,0.00%,0,0.00%,0,0.00%,0,0.00%
56,5190.0,263,243,92.40%,242,92.02%,244,92.78%,1,0.38%,1,0.38%
57,9999.0,1,0,0.00%,0,0.00%,0,0.00%,0,0.00%,0,0.00%
58,5153.0,159,101,63.52%,100,62.89%,107,67.30%,6,3.77%,1,0.63%
59,9999.0,2,0,0.00%,0,0.00%,0,0.00%,0,0.00%,0,0.00%
60,5112.0,139,109,78.42%,100,71.94%,109,78.42%,0,0.00%,9,6.47%
61,9999.0,5,0,0.00%,0,0.00%,0,0.00%,0,0.00%,0,0.00%
62,6105.0,238,132,55.46%,132,55.46%,147,61.76%,15,6.30%,0,0.00%
63,5017.0,258,215,83.33%,212,82.17%,218,84.50%,3,1.16%,3,1.16%
64,9999.0,5,1,20.00%,1,20.00%,1,20.00%,0,0.00%,0,0.00%
65,4951.0,274,253,92.34%,242,88.32%,254,92.70%,1,0.36%,11,4.01%
66,9999.0,8,1,12.50%,0,0.00%,1,12.50%,0,0.00%,1,12.50%
67,254.0,437,422,96.57%,422,96.57%,423,96.80%,1,0.23%,0,0.00%
68,9999.0,2,1,50.00%,1,50.00%,1,50.00%,0,0.00%,0,0.00%
69,8305.0,641,575,89.70%,570,88.92%,576,89.86%,1,0.16%,5,0.78%
70,53.0,61,44,72.13%,44,72.13%,47,77.05%,3,4.92%,0,0.00%
71,7101.0,348,277,79.60%,271,77.87%,297,85.34%,20,5.75%,6,1.72%
72,309.0,293,233,79.52%,229,78.16%,242,82.59%,9,3.07%,4,1.37%
73,9999.0,1,0,0.00%,0,0.00%,0,0.00%,0,0.00%,0,0.00%
74,435.0,300,231,77.00%,226,75.33%,241,80.33%,10,3.33%,5,1.67%
75,9999.0,5,0,0.00%,0,0.00%,0,0.00%,0,0.00%,0,0.00%
76,448.0,151,128,84.77%,126,83.44%,128,84.77%,0,0.00%,2,1.32%
77,9999.0,5,1,20.00%,1,20.00%,1,20.00%,0,0.00%,0,0.00%
78,6928.0,62,55,88.71%,55,88.71%,56,90.32%,1,1.61%,0,0.00%
79,460.0,375,271,72.27%,271,72.27%,294,78.40%,23,6.13%,0,0.00%
80,9999.0,7,0,0.00%,0,0.00%,0,0.00%,0,0.00%,0,0.00%
81,8392.0,5,1,20.00%,1,20.00%,2,40.00%,1,20.00%,0,0.00%
82,440.0,110,65,59.09%,60,54.55%,68,61.82%,3,2.73%,5,4.55%
83,9999.0,4,0,0.00%,0,0.00%,0,0.00%,0,0.00%,0,0.00%
84,470.0,189,170,89.95%,170,89.95%,170,89.95%,0,0.00%,0,0.00%
85,9999.0,2,0,0.00%,0,0.00%,0,0.00%,0,0.00%,0,0.00%
86,467.0,171,167,97.66%,167,97.66%,167,97.66%,0,0.00%,0,0.00%
87,9999.0,3,1,33.33%,1,33.33%,2,66.67%,1,33.33%,0,0.00%
88,196.0,114,70,61.40%,66,57.89%,76,66.67%,6,5.26%,4,3.51%
89,9999.0,2,0,0.00%,0,0.00%,0,0.00%,0,0.00%,0,0.00%
90,477.0,64,45,70.31%,44,68.75%,45,70.31%,0,0.00%,1,1.56%
91,9999.0,5,1,20.00%,0,0.00%,1,20.00%,0,0.00%,1,20.00%
92,492.0,336,311,92.56%,311,92.56%,311,92.56%,0,0.00%,0,0.00%
93,9999.0,3,0,0.00%,0,0.00%,0,0.00%,0,0.00%,0,0.00%
94,509.0,255,223,87.45%,220,86.27%,225,88.24%,2,0.78%,3,1.18%
95,523.0,206,173,83.98%,171,83.01%,174,84.47%,1,0.49%,2,0.97%
96,536.0,246,186,75.61%,174,70.73%,189,76.83%,3,1.22%,12,4.88%
97,9999.0,5,0,0.00%,0,0.00%,0,0.00%,0,0.00%,0,0.00%
98,107.0,255,188,73.73%,182,71.37%,197,77.25%,9,3.53%,6,2.35%
99,9999.0,7,1,14.29%,1,14.29%,4,57.14%,3,42.86%,0,0.00%
100,7821.0,93,56,60.22%,52,55.91%,60,64.52%,4,4.30%,4,4.30%
101,8129.0,50,44,88.00%,38,76.00%,45,90.00%,1,2.00%,6,12.00%
102,2320.0,67,39,58.21%,38,56.72%,41,61.19%,2,2.99%,1,1.49%
103,9999.0,4,0,0.00%,0,0.00%,0,0.00%,0,0.00%,0,0.00%
104,7640.0,66,39,59.09%,38,57.58%,40,60.61%,1,1.52%,1,1.52%
105,8342.0,220,0,0.00%,0,0.00%,0,0.00%,0,0.00%,0,0.00%
106,9999.0,2,0,0.00%,0,0.00%,0,0.00%,0,0.00%,0,0.00%
107,594.0,160,133,83.13%,126,78.75%,134,83.75%,1,0.63%,7,4.38%
108,7923.0,55,34,61.82%,34,61.82%,38,69.09%,4,7.27%,0,0.00%
109,4807.0,166,71,42.77%,64,38.55%,83,50.00%,12,7.23%,7,4.22%
110,7859.0,129,108,83.72%,108,83.72%,111,86.05%,3,2.33%,0,0.00%
111,8086.0,57,33,57.89%,24,42.11%,34,59.65%,1,1.75%,9,15.79%
112,6555.0,164,114,69.51%,102,62.20%,123,75.00%,9,5.49%,12,7.32%
113,9999.0,6,0,0.00%,0,0.00%,0,0.00%,0,0.00%,0,0.00%
114,640.0,169,136,80.47%,131,77.51%,138,81.66%,2,1.18%,5,2.96%
115,649.0,81,40,49.38%,39,48.15%,45,55.56%,5,6.17%,1,1.23%
116,6707.0,207,177,85.51%,170,82.13%,181,87.44%,4,1.93%,7,3.38%
117,9999.0,3,0,0.00%,0,0.00%,0,0.00%,0,0.00%,0,0.00%
118,8044.0,160,113,70.63%,112,70.00%,113,70.63%,0,0.00%,1,0.63%
119,6563.0,110,61,55.45%,51,46.36%,69,62.73%,8,7.27%,10,9.09%
120,7650.0,"1,294",686,53.01%,576,44.51%,712,55.02%,26,2.01%,110,8.50%
121,675.0,153,112,73.20%,108,70.59%,117,76.47%,5,3.27%,4,2.61%
122,695.0,105,59,56.19%,56,53.33%,60,57.14%,1,0.95%,3,2.86%
123,9999.0,1,0,0.00%,0,0.00%,1,100.00%,1,100.00%,0,0.00%
124,700.0,102,68,66.67%,66,64.71%,68,66.67%,0,0.00%,2,1.96%
125,9999.0,1,0,0.00%,0,0.00%,0,0.00%,0,0.00%,0,0.00%
126,8000.0,52,28,53.85%,27,51.92%,33,63.46%,5,9.62%,1,1.92%
127,9999.0,3,0,0.00%,0,0.00%,0,0.00%,0,0.00%,0,0.00%
128,714.0,89,66,74.16%,65,73.03%,66,74.16%,0,0.00%,1,1.12%
129,9999.0,1,0,0.00%,0,0.00%,0,0.00%,0,0.00%,0,0.00%
130,719.0,56,32,57.14%,29,51.79%,34,60.71%,2,3.57%,3,5.36%
131,9999.0,2,0,0.00%,0,0.00%,0,0.00%,0,0.00%,0,0.00%
132,726.0,146,74,50.68%,73,50.00%,80,54.79%,6,4.11%,1,0.68%
133,9999.0,1,0,0.00%,0,0.00%,0,0.00%,0,0.00%,0,0.00%
134,732.0,114,66,57.89%,60,52.63%,78,68.42%,12,10.53%,6,5.26%
135,9999.0,1,0,0.00%,0,0.00%,0,0.00%,0,0.00%,0,0.00%
136,7897.0,98,53,54.08%,53,54.08%,55,56.12%,2,2.04%,0,0.00%
137,747.0,79,35,44.30%,33,41.77%,36,45.57%,1,1.27%,2,2.53%
138,8154.0,34,15,44.12%,14,41.18%,16,47.06%,1,2.94%,1,2.94%
139,753.0,74,37,50.00%,32,43.24%,37,50.00%,0,0.00%,5,6.76%
140,8155.0,71,32,45.07%,32,45.07%,39,54.93%,7,9.86%,0,0.00%
141,820.0,81,65,80.25%,65,80.25%,66,81.48%,1,1.23%,0,0.00%
142,9999.0,3,0,0.00%,0,0.00%,0,0.00%,0,0.00%,0,0.00%
143,6306.0,522,385,73.75%,376,72.03%,389,74.52%,4,0.77%,9,1.72%
144,9999.0,19,3,15.79%,2,10.53%,4,21.05%,1,5.26%,1,5.26%
145,6308.0,113,75,66.37%,72,63.72%,75,66.37%,0,0.00%,3,2.65%
146,9999.0,1,0,0.00%,0,0.00%,0,0.00%,0,0.00%,0,0.00%
147,777.0,242,174,71.90%,165,68.18%,181,74.79%,7,2.89%,9,3.72%
148,9999.0,2,1,50.00%,0,0.00%,1,50.00%,0,0.00%,1,50.00%
149,4810.0,287,219,76.31%,219,76.31%,224,78.05%,5,1.74%,0,0.00%
150,9999.0,5,0,0.00%,0,0.00%,0,0.00%,0,0.00%,0,0.00%
151,788.0,327,233,71.25%,231,70.64%,241,73.70%,8,2.45%,2,0.61%
152,9999.0,6,2,33.33%,2,33.33%,2,33.33%,0,0.00%,0,0.00%
153,5023.0,193,129,66.84%,121,62.69%,130,67.36%,1,0.52%,8,4.15%
154,802.0,327,230,70.34%,225,68.81%,236,72.17%,6,1.83%,5,1.53%
155,808.0,169,102,60.36%,92,54.44%,102,60.36%,0,0.00%,10,5.92%
156,9999.0,1,0,0.00%,0,0.00%,0,0.00%,0,0.00%,0,0.00%
157,816.0,113,77,68.14%,77,68.14%,87,76.99%,10,8.85%,0,0.00%
158,6610.0,265,179,67.55%,173,65.28%,179,67.55%,0,0.00%,6,2.26%
159,6318.0,135,101,74.81%,101,74.81%,111,82.22%,10,7.41%,0,0.00%
160,9999.0,8,2,25.00%,2,25.00%,3,37.50%,1,12.50%,0,0.00%
161,8116.0,795,478,60.13%,442,55.60%,483,60.75%,5,0.63%,36,4.53%
162,9999.0,8,0,0.00%,0,0.00%,0,0.00%,0,0.00%,0,0.00%
163,864.0,144,110,76.39%,105,72.92%,114,79.17%,4,2.78%,5,3.47%
164,9999.0,1,0,0.00%,0,0.00%,0,0.00%,0,0.00%,0,0.00%
165,4670.0,111,58,52.25%,58,52.25%,62,55.86%,4,3.60%,0,0.00%
166,9999.0,1,0,0.00%,0,0.00%,0,0.00%,0,0.00%,0,0.00%
167,873.0,266,191,71.80%,180,67.67%,195,73.31%,4,1.50%,11,4.14%
168,9999.0,17,4,23.53%,4,23.53%,6,35.29%,2,11.76%,0,0.00%
169,6980.0,489,290,59.30%,290,59.30%,294,60.12%,4,0.82%,0,0.00%
170,9999.0,2,0,0.00%,0,0.00%,0,0.00%,0,0.00%,0,0.00%
171,887.0,166,134,80.72%,133,80.12%,136,81.93%,2,1.20%,1,0.60%
172,9999.0,5,1,20.00%,1,20.00%,1,20.00%,0,0.00%,0,0.00%
173,7720.0,16,4,25.00%,3,18.75%,4,25.00%,0,0.00%,1,6.25%
174,913.0,533,302,56.66%,294,55.16%,336,63.04%,34,6.38%,8,1.50%
175,7425.0,3,0,0.00%,0,0.00%,0,0.00%,0,0.00%,0,0.00%
176,917.0,85,58,68.24%,58,68.24%,58,68.24%,0,0.00%,0,0.00%
177,9999.0,2,0,0.00%,0,0.00%,0,0.00%,0,0.00%,0,0.00%
178,921.0,53,0,0.00%,0,0.00%,0,0.00%,0,0.00%,0,0.00%
179,5207.0,263,172,65.40%,168,63.88%,178,67.68%,6,2.28%,4,1.52%
180,9999.0,1,0,0.00%,0,0.00%,0,0.00%,0,0.00%,0,0.00%
181,941.0,138,88,63.77%,84,60.87%,92,66.67%,4,2.90%,4,2.90%
182,9999.0,1,0,0.00%,0,0.00%,0,0.00%,0,0.00%,0,0.00%
183,949.0,131,83,63.36%,79,60.31%,88,67.18%,5,3.82%,4,3.05%
184,951.0,29,13,44.83%,10,34.48%,15,51.72%,2,6.90%,3,10.34%
185,9999.0,2,0,0.00%,0,0.00%,0,0.00%,0,0.00%,0,0.00%
186,958.0,151,80,52.98%,77,50.99%,82,54.30%,2,1.32%,3,1.99%
187,988.0,69,40,57.97%,40,57.97%,40,57.97%,0,0.00%,0,0.00%
188,964.0,75,37,49.33%,34,45.33%,41,54.67%,4,5.33%,3,4.00%
189,965.0,62,36,58.06%,36,58.06%,42,67.74%,6,9.68%,0,0.00%
190,5208.0,111,72,64.86%,68,61.26%,78,70.27%,6,5.41%,4,3.60%
191,1000.0,97,57,58.76%,57,58.76%,60,61.86%,3,3.09%,0,0.00%
192,1005.0,88,50,56.82%,49,55.68%,50,56.82%,0,0.00%,1,1.14%
193,7726.0,26,14,53.85%,14,53.85%,16,61.54%,2,7.69%,0,0.00%
194,5116.0,396,320,80.81%,318,80.30%,326,82.32%,6,1.52%,2,0.51%
195,9999.0,20,0,0.00%,0,0.00%,0,0.00%,0,0.00%,0,0.00%
196,1014.0,64,48,75.00%,48,75.00%,53,82.81%,5,7.81%,0,0.00%
197,9999.0,6,1,16.67%,1,16.67%,1,16.67%,0,0.00%,0,0.00%
198,1029.0,370,215,58.11%,215,58.11%,232,62.70%,17,4.59%,0,0.00%
199,9999.0,26,0,0.00%,0,0.00%,0,0.00%,0,0.00%,0,0.00%
200,1030.0,298,214,71.81%,214,71.81%,245,82.21%,31,10.40%,0,0.00%
201,1040.0,408,326,79.90%,324,79.41%,336,82.35%,10,2.45%,2,0.49%
202,9999.0,17,5,29.41%,5,29.41%,5,29.41%,0,0.00%,0,0.00%
203,1043.0,477,434,90.99%,434,90.99%,434,90.99%,0,0.00%,0,0.00%
204,5133.0,504,472,93.65%,472,93.65%,472,93.65%,0,0.00%,0,0.00%
205,7790.0,549,511,93.08%,509,92.71%,512,93.26%,1,0.18%,2,0.36%
206,9999.0,17,1,5.88%,1,5.88%,1,5.88%,0,0.00%,0,0.00%
207,5096.0,421,380,90.26%,380,90.26%,381,90.50%,1,0.24%,0,0.00%
208,7749.0,522,473,90.61%,470,90.04%,480,91.95%,7,1.34%,3,0.57%
209,7568.0,59,51,86.44%,51,86.44%,52,88.14%,1,1.69%,0,0.00%
210,8381.0,54,43,79.63%,43,79.63%,46,85.19%,3,5.56%,0,0.00%
211,9999.0,1,0,0.00%,0,0.00%,0,0.00%,0,0.00%,0,0.00%
212,6455.0,626,560,89.46%,559,89.30%,574,91.69%,14,2.24%,1,0.16%
213,9999.0,10,1,10.00%,1,10.00%,1,10.00%,0,0.00%,0,0.00%
214,1084.0,128,123,96.09%,123,96.09%,123,96.09%,0,0.00%,0,0.00%
215,9999.0,3,0,0.00%,0,0.00%,0,0.00%,0,0.00%,0,0.00%
216,1094.0,139,109,78.42%,109,78.42%,112,80.58%,3,2.16%,0,0.00%
217,9999.0,5,0,0.00%,0,0.00%,0,0.00%,0,0.00%,0,0.00%
218,1100.0,562,454,80.78%,453,80.60%,458,81.49%,4,0.71%,1,0.18%
219,9999.0,11,0,0.00%,0,0.00%,0,0.00%,0,0.00%,0,0.00%
220,4682.0,805,666,82.73%,663,82.36%,679,84.35%,13,1.61%,3,0.37%
221,9999.0,2,0,0.00%,0,0.00%,0,0.00%,0,0.00%,0,0.00%
222,1128.0,381,296,77.69%,293,76.90%,299,78.48%,3,0.79%,3,0.79%
223,9999.0,7,1,14.29%,1,14.29%,1,14.29%,0,0.00%,0,0.00%
224,8344.0,518,402,77.61%,386,74.52%,435,83.98%,33,6.37%,16,3.09%
225,9999.0,28,3,10.71%,3,10.71%,4,14.29%,1,3.57%,0,0.00%
226,1154.0,135,78,57.78%,75,55.56%,84,62.22%,6,4.44%,3,2.22%
227,9999.0,1,0,0.00%,0,0.00%,0,0.00%,0,0.00%,0,0.00%
228,1159.0,278,241,86.69%,241,86.69%,245,88.13%,4,1.44%,0,0.00%
229,9999.0,6,0,0.00%,0,0.00%,0,0.00%,0,0.00%,0,0.00%
230,1164.0,96,50,52.08%,43,44.79%,50,52.08%,0,0.00%,7,7.29%
231,9999.0,2,0,0.00%,0,0.00%,0,0.00%,0,0.00%,0,0.00%
232,1172.0,138,90,65.22%,88,63.77%,90,65.22%,0,0.00%,2,1.45%
233,9999.0,3,0,0.00%,0,0.00%,0,0.00%,0,0.00%,0,0.00%
234,1177.0,208,145,69.71%,145,69.71%,158,75.96%,13,6.25%,0,0.00%
235,9999.0,1,0,0.00%,0,0.00%,1,100.00%,1,100.00%,0,0.00%
236,8318.0,542,453,83.58%,453,83.58%,470,86.72%,17,3.14%,0,0.00%
237,9999.0,6,2,33.33%,2,33.33%,2,33.33%,0,0.00%,0,0.00%
238,5135.0,47,28,59.57%,28,59.57%,30,63.83%,2,4.26%,0,0.00%
239,5212.0,115,68,59.13%,68,59.13%,76,66.09%,8,6.96%,0,0.00%
240,9999.0,2,0,0.00%,0,0.00%,0,0.00%,0,0.00%,0,0.00%
241,1208.0,137,99,72.26%,98,71.53%,106,77.37%,7,5.11%,1,0.73%
242,9999.0,1,0,0.00%,0,0.00%,0,0.00%,0,0.00%,0,0.00%
243,5136.0,73,41,56.16%,41,56.16%,41,56.16%,0,0.00%,0,0.00%
244,1225.0,54,37,68.52%,35,64.81%,39,72.22%,2,3.70%,2,3.70%
245,8382.0,145,91,62.76%,81,55.86%,102,70.34%,11,7.59%,10,6.90%
246,1251.0,181,126,69.61%,102,56.35%,126,69.61%,0,0.00%,24,13.26%
247,8314.0,8,1,12.50%,0,0.00%,1,12.50%,0,0.00%,1,12.50%
248,9999.0,12,0,0.00%,0,0.00%,0,0.00%,0,0.00%,0,0.00%
249,6201.0,83,58,69.88%,58,69.88%,59,71.08%,1,1.20%,0,0.00%
250,1213.0,123,92,74.80%,85,69.11%,93,75.61%,1,0.81%,7,5.69%
251,9999.0,2,0,0.00%,0,0.00%,0,0.00%,0,0.00%,0,0.00%
252,1270.0,68,54,79.41%,48,70.59%,56,82.35%,2,2.94%,6,8.82%
253,7941.0,127,102,80.31%,100,78.74%,105,82.68%,3,2.36%,2,1.57%
254,9999.0,2,0,0.00%,0,0.00%,0,0.00%,0,0.00%,0,0.00%
255,8379.0,102,92,90.20%,92,90.20%,92,90.20%,0,0.00%,0,0.00%
256,1299.0,51,26,50.98%,21,41.18%,31,60.78%,5,9.80%,5,9.80%
257,9999.0,1,0,0.00%,0,0.00%,0,0.00%,0,0.00%,0,0.00%
258,4870.0,93,34,36.56%,32,34.41%,34,36.56%,0,0.00%,2,2.15%
259,1307.0,122,90,73.77%,88,72.13%,95,77.87%,5,4.10%,2,1.64%
260,9999.0,3,0,0.00%,0,0.00%,0,0.00%,0,0.00%,0,0.00%
261,1315.0,163,109,66.87%,108,66.26%,120,73.62%,11,6.75%,1,0.61%
262,4734.0,114,89,78.07%,89,78.07%,92,80.70%,3,2.63%,0,0.00%
263,9999.0,8,0,0.00%,0,0.00%,0,0.00%,0,0.00%,0,0.00%
264,8348.0,112,56,50.00%,53,47.32%,56,50.00%,0,0.00%,3,2.68%
265,9999.0,6,1,16.67%,1,16.67%,1,16.67%,0,0.00%,0,0.00%
266,1327.0,50,31,62.00%,31,62.00%,32,64.00%,1,2.00%,0,0.00%
267,9999.0,2,0,0.00%,0,0.00%,0,0.00%,0,0.00%,0,0.00%
268,1335.0,144,73,50.69%,68,47.22%,79,54.86%,6,4.17%,5,3.47%
269,1343.0,198,130,65.66%,127,64.14%,134,67.68%,4,2.02%,3,1.52%
270,6231.0,100,78,78.00%,75,75.00%,83,83.00%,5,5.00%,3,3.00%
271,1364.0,579,453,78.24%,447,77.20%,453,78.24%,0,0.00%,6,1.04%
272,7691.0,156,66,42.31%,66,42.31%,73,46.79%,7,4.49%,0,0.00%
273,7721.0,70,58,82.86%,54,77.14%,58,82.86%,0,0.00%,4,5.71%
274,7819.0,358,236,65.92%,234,65.36%,270,75.42%,34,9.50%,2,0.56%
275,1367.0,429,384,89.51%,375,87.41%,386,89.98%,2,0.47%,9,2.10%
276,9999.0,8,1,12.50%,1,12.50%,1,12.50%,0,0.00%,0,0.00%
277,5012.0,420,310,73.81%,281,66.90%,324,77.14%,14,3.33%,29,6.90%
278,8415.0,38,10,26.32%,8,21.05%,11,28.95%,1,2.63%,2,5.26%
279,9999.0,12,0,0.00%,0,0.00%,0,0.00%,0,0.00%,0,0.00%
280,1387.0,358,304,84.92%,299,83.52%,307,85.75%,3,0.84%,5,1.40%
281,7759.0,452,410,90.71%,408,90.27%,415,91.81%,5,1.11%,2,0.44%
282,8174.0,194,194,100.00%,194,100.00%,194,100.00%,0,0.00%,0,0.00%
283,9999.0,12,2,16.67%,2,16.67%,2,16.67%,0,0.00%,0,0.00%
284,7628.0,74,63,85.14%,63,85.14%,66,89.19%,3,4.05%,0,0.00%
285,7636.0,72,66,91.67%,66,91.67%,70,97.22%,4,5.56%,0,0.00%
286,1424.0,312,289,92.63%,289,92.63%,289,92.63%,0,0.00%,0,0.00%
287,9999.0,18,0,0.00%,0,0.00%,0,0.00%,0,0.00%,0,0.00%
288,6482.0,330,274,83.03%,273,82.73%,287,86.97%,13,3.94%,1,0.30%
289,9999.0,4,1,25.00%,1,25.00%,1,25.00%,0,0.00%,0,0.00%
290,1414.0,192,123,64.06%,108,56.25%,123,64.06%,0,0.00%,15,7.81%
291,9999.0,4,0,0.00%,0,0.00%,0,0.00%,0,0.00%,0,0.00%
292,1406.0,395,341,86.33%,340,86.08%,348,88.10%,7,1.77%,1,0.25%
293,9999.0,23,6,26.09%,6,26.09%,8,34.78%,2,8.70%,0,0.00%
294,1420.0,329,226,68.69%,220,66.87%,234,71.12%,8,2.43%,6,1.82%
295,9999.0,2,0,0.00%,0,0.00%,0,0.00%,0,0.00%,0,0.00%
296,1426.0,279,238,85.30%,235,84.23%,245,87.81%,7,2.51%,3,1.08%
297,9999.0,6,2,33.33%,2,33.33%,3,50.00%,1,16.67%,0,0.00%
298,1423.0,536,522,97.39%,522,97.39%,522,97.39%,0,0.00%,0,0.00%
299,9999.0,20,7,35.00%,6,30.00%,7,35.00%,0,0.00%,1,5.00%
300,1443.0,355,341,96.06%,341,96.06%,342,96.34%,1,0.28%,0,0.00%
301,9999.0,1,0,0.00%,0,0.00%,0,0.00%,0,0.00%,0,0.00%
302,1453.0,285,262,91.93%,262,91.93%,264,92.63%,2,0.70%,0,0.00%
303,6734.0,303,275,90.76%,275,90.76%,283,93.40%,8,2.64%,0,0.00%
304,7894.0,306,283,92.48%,283,92.48%,287,93.79%,4,1.31%,0,0.00%
305,9999.0,31,1,3.23%,1,3.23%,1,3.23%,0,0.00%,0,0.00%
306,7824.0,93,35,37.63%,35,37.63%,44,47.31%,9,9.68%,0,0.00%
307,4664.0,56,35,62.50%,27,48.21%,37,66.07%,2,3.57%,8,14.29%
308,9999.0,18,0,0.00%,0,0.00%,0,0.00%,0,0.00%,0,0.00%
309,1475.0,66,46,69.70%,46,69.70%,49,74.24%,3,4.55%,0,0.00%
310,1480.0,57,32,56.14%,31,54.39%,35,61.40%,3,5.26%,1,1.75%
311,9999.0,1,0,0.00%,0,0.00%,0,0.00%,0,0.00%,0,0.00%
312,1486.0,69,49,71.01%,40,57.97%,52,75.36%,3,4.35%,9,13.04%
313,9999.0,2,0,0.00%,0,0.00%,0,0.00%,0,0.00%,0,0.00%
314,1489.0,46,28,60.87%,28,60.87%,28,60.87%,0,0.00%,0,0.00%
315,1495.0,55,33,60.00%,33,60.00%,38,69.09%,5,9.09%,0,0.00%
316,9999.0,2,0,0.00%,0,0.00%,0,0.00%,0,0.00%,0,0.00%
317,1501.0,38,21,55.26%,20,52.63%,25,65.79%,4,10.53%,1,2.63%
318,9999.0,1,0,0.00%,0,0.00%,0,0.00%,0,0.00%,0,0.00%
319,6156.0,250,147,58.80%,146,58.40%,158,63.20%,11,4.40%,1,0.40%
320,9999.0,5,0,0.00%,0,0.00%,0,0.00%,0,0.00%,0,0.00%
321,6236.0,167,101,60.48%,95,56.89%,103,61.68%,2,1.20%,6,3.59%
322,1529.0,89,61,68.54%,56,62.92%,61,68.54%,0,0.00%,5,5.62%
323,5219.0,52,26,50.00%,25,48.08%,26,50.00%,0,0.00%,1,1.92%
324,8316.0,23,10,43.48%,9,39.13%,13,56.52%,3,13.04%,1,4.35%
325,9999.0,1,0,0.00%,0,0.00%,0,0.00%,0,0.00%,0,0.00%
326,1550.0,75,49,65.33%,43,57.33%,51,68.00%,2,2.67%,6,8.00%
327,1560.0,138,75,54.35%,66,47.83%,75,54.35%,0,0.00%,9,6.52%
328,1566.0,73,46,63.01%,43,58.90%,46,63.01%,0,0.00%,3,4.11%
329,7635.0,25,13,52.00%,13,52.00%,16,64.00%,3,12.00%,0,0.00%
330,6241.0,20,15,75.00%,12,60.00%,15,75.00%,0,0.00%,3,15.00%
331,7589.0,281,139,49.47%,135,48.04%,139,49.47%,0,0.00%,4,1.42%
332,1595.0,41,19,46.34%,19,46.34%,19,46.34%,0,0.00%,0,0.00%
333,1605.0,157,114,72.61%,110,70.06%,116,73.89%,2,1.27%,4,2.55%
334,9999.0,6,3,50.00%,3,50.00%,3,50.00%,0,0.00%,0,0.00%
335,1612.0,113,77,68.14%,77,68.14%,78,69.03%,1,0.88%,0,0.00%
336,9999.0,6,0,0.00%,0,0.00%,0,0.00%,0,0.00%,0,0.00%
337,1619.0,126,108,85.71%,108,85.71%,109,86.51%,1,0.79%,0,0.00%
338,5178.0,148,51,34.46%,51,34.46%,54,36.49%,3,2.03%,0,0.00%
339,1623.0,45,33,73.33%,33,73.33%,33,73.33%,0,0.00%,0,0.00%
340,9999.0,3,0,0.00%,0,0.00%,0,0.00%,0,0.00%,0,0.00%
341,1627.0,99,74,74.75%,74,74.75%,78,78.79%,4,4.04%,0,0.00%
342,7567.0,23,12,52.17%,9,39.13%,16,69.57%,4,17.39%,3,13.04%
343,8224.0,171,74,43.27%,71,41.52%,88,51.46%,14,8.19%,3,1.75%
344,1632.0,81,35,43.21%,32,39.51%,36,44.44%,1,1.23%,3,3.70%
345,1654.0,233,135,57.94%,128,54.94%,138,59.23%,3,1.29%,7,3.00%
346,1629.0,64,36,56.25%,35,54.69%,43,67.19%,7,10.94%,1,1.56%
347,6136.0,87,50,57.47%,49,56.32%,55,63.22%,5,5.75%,1,1.15%
348,6942.0,90,42,46.67%,39,43.33%,49,54.44%,7,7.78%,3,3.33%
349,9999.0,2,0,0.00%,0,0.00%,0,0.00%,0,0.00%,0,0.00%
350,1677.0,217,118,54.38%,113,52.07%,122,56.22%,4,1.84%,5,2.30%
351,9999.0,2,0,0.00%,0,0.00%,0,0.00%,0,0.00%,0,0.00%
352,1682.0,97,88,90.72%,88,90.72%,90,92.78%,2,2.06%,0,0.00%
353,1694.0,378,263,69.58%,259,68.52%,266,70.37%,3,0.79%,4,1.06%
354,9999.0,12,0,0.00%,0,0.00%,0,0.00%,0,0.00%,0,0.00%
355,1701.0,621,507,81.64%,505,81.32%,514,82.77%,7,1.13%,2,0.32%
356,9999.0,7,0,0.00%,0,0.00%,0,0.00%,0,0.00%,0,0.00%
357,1707.0,189,132,69.84%,130,68.78%,133,70.37%,1,0.53%,2,1.06%
358,5098.0,266,206,77.44%,205,77.07%,206,77.44%,0,0.00%,1,0.38%
359,9999.0,3,0,0.00%,0,0.00%,0,0.00%,0,0.00%,0,0.00%
360,5221.0,259,145,55.98%,144,55.60%,154,59.46%,9,3.47%,1,0.39%
361,6328.0,154,110,71.43%,107,69.48%,110,71.43%,0,0.00%,3,1.95%
362,7774.0,"1,027",486,47.32%,480,46.74%,559,54.43%,73,7.11%,6,0.58%
363,1745.0,386,323,83.68%,323,83.68%,324,83.94%,1,0.26%,0,0.00%
364,1746.0,325,170,52.31%,170,52.31%,170,52.31%,0,0.00%,0,0.00%
365,9999.0,8,0,0.00%,0,0.00%,0,0.00%,0,0.00%,0,0.00%
366,5278.0,232,124,53.45%,111,47.84%,127,54.74%,3,1.29%,13,5.60%
367,4801.0,276,259,93.84%,259,93.84%,259,93.84%,0,0.00%,0,0.00%
368,6330.0,73,52,71.23%,44,60.27%,52,71.23%,0,0.00%,8,10.96%
369,6333.0,157,88,56.05%,86,54.78%,90,57.32%,2,1.27%,2,1.27%
370,7902.0,74,70,94.59%,70,94.59%,70,94.59%,0,0.00%,0,0.00%
371,8376.0,13,5,38.46%,5,38.46%,6,46.15%,1,7.69%,0,0.00%
372,9999.0,41,0,0.00%,0,0.00%,0,0.00%,0,0.00%,0,0.00%
373,1776.0,306,196,64.05%,196,64.05%,199,65.03%,3,0.98%,0,0.00%
374,7844.0,5,0,0.00%,0,0.00%,0,0.00%,0,0.00%,0,0.00%
375,9999.0,4,0,0.00%,0,0.00%,0,0.00%,0,0.00%,0,0.00%
376,1790.0,157,116,73.89%,114,72.61%,116,73.89%,0,0.00%,2,1.27%
377,9999.0,3,0,0.00%,0,0.00%,0,0.00%,0,0.00%,0,0.00%
378,1794.0,63,47,74.60%,45,71.43%,48,76.19%,1,1.59%,2,3.17%
379,8278.0,51,39,76.47%,39,76.47%,39,76.47%,0,0.00%,0,0.00%
380,1801.0,69,46,66.67%,46,66.67%,52,75.36%,6,8.70%,0,0.00%
381,9999.0,4,0,0.00%,0,0.00%,0,0.00%,0,0.00%,0,0.00%
382,1806.0,184,153,83.15%,148,80.43%,153,83.15%,0,0.00%,5,2.72%
383,9999.0,18,11,61.11%,10,55.56%,11,61.11%,0,0.00%,1,5.56%
384,6340.0,90,59,65.56%,59,65.56%,59,65.56%,0,0.00%,0,0.00%
385,9999.0,1,0,0.00%,0,0.00%,0,0.00%,0,0.00%,0,0.00%
386,6492.0,189,96,50.79%,96,50.79%,96,50.79%,0,0.00%,0,0.00%
387,8303.0,106,83,78.30%,83,78.30%,97,91.51%,14,13.21%,0,0.00%
388,9999.0,15,1,6.67%,1,6.67%,1,6.67%,0,0.00%,0,0.00%
389,1849.0,185,126,68.11%,122,65.95%,136,73.51%,10,5.41%,4,2.16%
390,9999.0,5,0,0.00%,0,0.00%,0,0.00%,0,0.00%,0,0.00%
391,1869.0,416,380,91.35%,380,91.35%,384,92.31%,4,0.96%,0,0.00%
392,9999.0,3,1,33.33%,1,33.33%,1,33.33%,0,0.00%,0,0.00%
393,1879.0,415,369,88.92%,367,88.43%,374,90.12%,5,1.20%,2,0.48%
394,9999.0,7,2,28.57%,2,28.57%,2,28.57%,0,0.00%,0,0.00%
395,1885.0,243,185,76.13%,177,72.84%,187,76.95%,2,0.82%,8,3.29%
396,9999.0,1,0,0.00%,0,0.00%,0,0.00%,0,0.00%,0,0.00%
397,1902.0,254,225,88.58%,225,88.58%,236,92.91%,11,4.33%,0,0.00%
398,9999.0,5,0,0.00%,0,0.00%,0,0.00%,0,0.00%,0,0.00%
399,1915.0,279,234,83.87%,233,83.51%,234,83.87%,0,0.00%,1,0.36%
400,9999.0,3,0,0.00%,0,0.00%,0,0.00%,0,0.00%,0,0.00%
401,1921.0,267,244,91.39%,244,91.39%,248,92.88%,4,1.50%,0,0.00%
402,9999.0,6,0,0.00%,0,0.00%,0,0.00%,0,0.00%,0,0.00%
403,1934.0,449,359,79.96%,355,79.06%,374,83.30%,15,3.34%,4,0.89%
404,9999.0,2,1,50.00%,1,50.00%,1,50.00%,0,0.00%,0,0.00%
405,1942.0,292,264,90.41%,262,89.73%,266,91.10%,2,0.68%,2,0.68%
406,9999.0,3,0,0.00%,0,0.00%,0,0.00%,0,0.00%,0,0.00%
407,6516.0,285,165,57.89%,165,57.89%,178,62.46%,13,4.56%,0,0.00%
408,9999.0,6,0,0.00%,0,0.00%,0,0.00%,0,0.00%,0,0.00%
409,1950.0,278,256,92.09%,254,91.37%,265,95.32%,9,3.24%,2,0.72%
410,9999.0,4,0,0.00%,0,0.00%,0,0.00%,0,0.00%,0,0.00%
411,1972.0,836,517,61.84%,509,60.89%,520,62.20%,3,0.36%,8,0.96%
412,9999.0,26,9,34.62%,9,34.62%,9,34.62%,0,0.00%,0,0.00%
413,5287.0,300,269,89.67%,269,89.67%,270,90.00%,1,0.33%,0,0.00%
414,9999.0,5,0,0.00%,0,0.00%,0,0.00%,0,0.00%,0,0.00%
415,8231.0,300,227,75.67%,197,65.67%,227,75.67%,0,0.00%,30,10.00%
416,9999.0,1,0,0.00%,0,0.00%,0,0.00%,0,0.00%,0,0.00%
417,6218.0,31,22,70.97%,21,67.74%,23,74.19%,1,3.23%,1,3.23%
418,1989.0,55,37,67.27%,37,67.27%,40,72.73%,3,5.45%,0,0.00%
419,9999.0,1,0,0.00%,0,0.00%,0,0.00%,0,0.00%,0,0.00%
420,5169.0,174,106,60.92%,106,60.92%,109,62.64%,3,1.72%,0,0.00%
421,9999.0,1,0,0.00%,0,0.00%,0,0.00%,0,0.00%,0,0.00%
422,7770.0,76,42,55.26%,36,47.37%,46,60.53%,4,5.26%,6,7.89%
423,1998.0,147,76,51.70%,67,45.58%,76,51.70%,0,0.00%,9,6.12%
424,9999.0,1,0,0.00%,0,0.00%,0,0.00%,0,0.00%,0,0.00%
425,7515.0,201,190,94.53%,190,94.53%,193,96.02%,3,1.49%,0,0.00%
426,8417.0,464,135,29.09%,119,25.65%,147,31.68%,12,2.59%,16,3.45%
427,9999.0,9,0,0.00%,0,0.00%,0,0.00%,0,0.00%,0,0.00%
428,6737.0,123,102,82.93%,102,82.93%,108,87.80%,6,4.88%,0,0.00%
429,9999.0,2,0,0.00%,0,0.00%,0,0.00%,0,0.00%,0,0.00%
430,2037.0,170,98,57.65%,94,55.29%,112,65.88%,14,8.24%,4,2.35%
431,9999.0,3,0,0.00%,0,0.00%,0,0.00%,0,0.00%,0,0.00%
432,2040.0,172,117,68.02%,115,66.86%,120,69.77%,3,1.74%,2,1.16%
433,9999.0,1,0,0.00%,0,0.00%,0,0.00%,0,0.00%,0,0.00%
434,2043.0,128,78,60.94%,69,53.91%,80,62.50%,2,1.56%,9,7.03%
435,9999.0,1,0,0.00%,0,0.00%,0,0.00%,0,0.00%,0,0.00%
436,7948.0,181,112,61.88%,111,61.33%,115,63.54%,3,1.66%,1,0.55%
437,9999.0,3,0,0.00%,0,0.00%,0,0.00%,0,0.00%,0,0.00%
438,4817.0,88,42,47.73%,40,45.45%,44,50.00%,2,2.27%,2,2.27%
439,9999.0,1,0,0.00%,0,0.00%,0,0.00%,0,0.00%,0,0.00%
440,8071.0,528,368,69.70%,365,69.13%,375,71.02%,7,1.33%,3,0.57%
441,9999.0,3,0,0.00%,0,0.00%,0,0.00%,0,0.00%,0,0.00%
442,6145.0,116,64,55.17%,63,54.31%,65,56.03%,1,0.86%,1,0.86%
443,6745.0,111,50,45.05%,43,38.74%,52,46.85%,2,1.80%,7,6.31%
444,2075.0,78,35,44.87%,35,44.87%,35,44.87%,0,0.00%,0,0.00%
445,6148.0,109,63,57.80%,55,50.46%,66,60.55%,3,2.75%,8,7.34%
446,9999.0,2,1,50.00%,1,50.00%,1,50.00%,0,0.00%,0,0.00%
447,6001.0,244,147,60.25%,126,51.64%,152,62.30%,5,2.05%,21,8.61%
448,9999.0,1,0,0.00%,0,0.00%,0,0.00%,0,0.00%,0,0.00%
449,4818.0,111,51,45.95%,43,38.74%,52,46.85%,1,0.90%,8,7.21%
450,5228.0,208,130,62.50%,130,62.50%,137,65.87%,7,3.37%,0,0.00%
451,9999.0,1,0,0.00%,0,0.00%,0,0.00%,0,0.00%,0,0.00%
452,2126.0,75,41,54.67%,34,45.33%,41,54.67%,0,0.00%,7,9.33%
453,6600.0,210,143,68.10%,143,68.10%,152,72.38%,9,4.29%,0,0.00%
454,9999.0,5,0,0.00%,0,0.00%,0,0.00%,0,0.00%,0,0.00%
455,6643.0,106,39,36.79%,39,36.79%,39,36.79%,0,0.00%,0,0.00%
456,2184.0,169,93,55.03%,93,55.03%,107,63.31%,14,8.28%,0,0.00%
457,9999.0,5,1,20.00%,1,20.00%,1,20.00%,0,0.00%,0,0.00%
458,6159.0,12,7,58.33%,7,58.33%,8,66.67%,1,8.33%,0,0.00%
459,6161.0,20,16,80.00%,15,75.00%,16,80.00%,0,0.00%,1,5.00%
460,9999.0,10,0,0.00%,0,0.00%,0,0.00%,0,0.00%,0,0.00%
461,2191.0,490,226,46.12%,217,44.29%,239,48.78%,13,2.65%,9,1.84%
462,8244.0,178,79,44.38%,78,43.82%,81,45.51%,2,1.12%,1,0.56%
463,9999.0,10,0,0.00%,0,0.00%,0,0.00%,0,0.00%,0,0.00%
464,2201.0,38,14,36.84%,14,36.84%,17,44.74%,3,7.89%,0,0.00%
465,2206.0,211,147,69.67%,140,66.35%,153,72.51%,6,2.84%,7,3.32%
466,6280.0,151,90,59.60%,90,59.60%,90,59.60%,0,0.00%,0,0.00%
467,9999.0,2,0,0.00%,0,0.00%,0,0.00%,0,0.00%,0,0.00%
468,2243.0,292,157,53.77%,151,51.71%,163,55.82%,6,2.05%,6,2.05%
469,9999.0,7,0,0.00%,0,0.00%,0,0.00%,0,0.00%,0,0.00%
470,6252.0,69,35,50.72%,31,44.93%,35,50.72%,0,0.00%,4,5.80%
471,2246.0,24,12,50.00%,12,50.00%,12,50.00%,0,0.00%,0,0.00%
472,2253.0,51,33,64.71%,32,62.75%,33,64.71%,0,0.00%,1,1.96%
473,7112.0,68,44,64.71%,40,58.82%,44,64.71%,0,0.00%,4,5.88%
474,5118.0,127,77,60.63%,77,60.63%,77,60.63%,0,0.00%,0,0.00%
475,2280.0,48,30,62.50%,27,56.25%,32,66.67%,2,4.17%,3,6.25%
476,2284.0,47,22,46.81%,20,42.55%,25,53.19%,3,6.38%,2,4.26%
477,7136.0,41,21,51.22%,21,51.22%,22,53.66%,1,2.44%,0,0.00%
478,9999.0,2,0,0.00%,0,0.00%,0,0.00%,0,0.00%,0,0.00%
479,2305.0,151,104,68.87%,91,60.26%,105,69.54%,1,0.66%,13,8.61%
480,9999.0,2,0,0.00%,0,0.00%,0,0.00%,0,0.00%,0,0.00%
481,2308.0,51,35,68.63%,33,64.71%,42,82.35%,7,13.73%,2,3.92%
482,7944.0,115,52,45.22%,47,40.87%,60,52.17%,8,6.96%,5,4.35%
483,2313.0,92,49,53.26%,46,50.00%,54,58.70%,5,5.43%,3,3.26%
484,7762.0,25,0,0.00%,0,0.00%,1,4.00%,1,4.00%,0,0.00%
485,2353.0,41,26,63.41%,22,53.66%,27,65.85%,1,2.44%,4,9.76%
486,4706.0,67,39,58.21%,39,58.21%,39,58.21%,0,0.00%,0,0.00%
487,9999.0,3,0,0.00%,0,0.00%,0,0.00%,0,0.00%,0,0.00%
488,2331.0,71,53,74.65%,53,74.65%,53,74.65%,0,0.00%,0,0.00%
489,2325.0,188,142,75.53%,136,72.34%,145,77.13%,3,1.60%,6,3.19%
490,9999.0,3,0,0.00%,0,0.00%,0,0.00%,0,0.00%,0,0.00%
491,2339.0,106,64,60.38%,62,58.49%,71,66.98%,7,6.60%,2,1.89%
492,2345.0,66,34,51.52%,34,51.52%,37,56.06%,3,4.55%,0,0.00%
493,9999.0,2,0,0.00%,0,0.00%,0,0.00%,0,0.00%,0,0.00%
494,2350.0,81,43,53.09%,34,41.98%,48,59.26%,5,6.17%,9,11.11%
495,9999.0,1,0,0.00%,0,0.00%,0,0.00%,0,0.00%,0,0.00%
496,2358.0,75,30,40.00%,30,40.00%,32,42.67%,2,2.67%,0,0.00%
497,9999.0,2,0,0.00%,0,0.00%,0,0.00%,0,0.00%,0,0.00%
498,2362.0,63,42,66.67%,35,55.56%,42,66.67%,0,0.00%,7,11.11%
499,6162.0,82,51,62.20%,50,60.98%,54,65.85%,3,3.66%,1,1.22%
500,5180.0,72,15,20.83%,12,16.67%,15,20.83%,0,0.00%,3,4.17%
501,6165.0,152,98,64.47%,86,56.58%,105,69.08%,7,4.61%,12,7.89%
502,9999.0,1,0,0.00%,0,0.00%,0,0.00%,0,0.00%,0,0.00%
503,2394.0,79,46,58.23%,39,49.37%,47,59.49%,1,1.27%,7,8.86%
504,6255.0,122,66,54.10%,57,46.72%,68,55.74%,2,1.64%,9,7.38%
505,5091.0,255,222,87.06%,220,86.27%,224,87.84%,2,0.78%,2,0.78%
506,9999.0,1,0,0.00%,0,0.00%,0,0.00%,0,0.00%,0,0.00%
507,2420.0,112,75,66.96%,75,66.96%,75,66.96%,0,0.00%,0,0.00%
508,8312.0,116,102,87.93%,101,87.07%,107,92.24%,5,4.31%,1,0.86%
509,6404.0,106,69,65.09%,69,65.09%,73,68.87%,4,3.77%,0,0.00%
510,8304.0,110,75,68.18%,74,67.27%,80,72.73%,5,4.55%,1,0.91%
511,2446.0,212,164,77.36%,164,77.36%,165,77.83%,1,0.47%,0,0.00%
512,9999.0,2,0,0.00%,0,0.00%,0,0.00%,0,0.00%,0,0.00%
513,2449.0,84,66,78.57%,64,76.19%,68,80.95%,2,2.38%,2,2.38%
514,2496.0,87,71,81.61%,68,78.16%,72,82.76%,1,1.15%,3,3.45%
515,2489.0,193,112,58.03%,112,58.03%,120,62.18%,8,4.15%,0,0.00%
516,6413.0,379,241,63.59%,240,63.32%,241,63.59%,0,0.00%,1,0.26%
517,9999.0,39,7,17.95%,7,17.95%,7,17.95%,0,0.00%,0,0.00%
518,6775.0,160,112,70.00%,110,68.75%,113,70.63%,1,0.63%,2,1.25%
519,9999.0,2,0,0.00%,0,0.00%,0,0.00%,0,0.00%,0,0.00%
520,6290.0,264,182,68.94%,166,62.88%,183,69.32%,1,0.38%,16,6.06%
521,9999.0,3,0,0.00%,0,0.00%,0,0.00%,0,0.00%,0,0.00%
522,2515.0,84,49,58.33%,42,50.00%,49,58.33%,0,0.00%,7,8.33%
523,9999.0,6,0,0.00%,0,0.00%,0,0.00%,0,0.00%,0,0.00%
524,2532.0,300,193,64.33%,190,63.33%,193,64.33%,0,0.00%,3,1.00%
525,9999.0,20,3,15.00%,3,15.00%,3,15.00%,0,0.00%,0,0.00%
526,2539.0,208,135,64.90%,119,57.21%,135,64.90%,0,0.00%,16,7.69%
527,9999.0,9,0,0.00%,0,0.00%,0,0.00%,0,0.00%,0,0.00%
528,2554.0,251,116,46.22%,101,40.24%,126,50.20%,10,3.98%,15,5.98%
529,9999.0,4,0,0.00%,0,0.00%,0,0.00%,0,0.00%,0,0.00%
530,2562.0,301,207,68.77%,206,68.44%,218,72.43%,11,3.65%,1,0.33%
531,6293.0,293,184,62.80%,164,55.97%,189,64.51%,5,1.71%,20,6.83%
532,9999.0,1,0,0.00%,0,0.00%,0,0.00%,0,0.00%,0,0.00%
533,7538.0,30,19,63.33%,19,63.33%,19,63.33%,0,0.00%,0,0.00%
534,2578.0,513,381,74.27%,368,71.73%,389,75.83%,8,1.56%,13,2.53%
535,9999.0,7,0,0.00%,0,0.00%,0,0.00%,0,0.00%,0,0.00%
536,2607.0,257,189,73.54%,184,71.60%,191,74.32%,2,0.78%,5,1.95%
537,9999.0,2,2,100.00%,2,100.00%,2,100.00%,0,0.00%,0,0.00%
538,2596.0,564,428,75.89%,377,66.84%,438,77.66%,10,1.77%,51,9.04%
539,7922.0,120,47,39.17%,45,37.50%,50,41.67%,3,2.50%,2,1.67%
540,9999.0,13,2,15.38%,1,7.69%,2,15.38%,0,0.00%,1,7.69%
541,2618.0,233,8,3.43%,8,3.43%,9,3.86%,1,0.43%,0,0.00%
542,9999.0,8,0,0.00%,0,0.00%,0,0.00%,0,0.00%,0,0.00%
543,2623.0,446,356,79.82%,345,77.35%,361,80.94%,5,1.12%,11,2.47%
544,9999.0,1,0,0.00%,0,0.00%,0,0.00%,0,0.00%,0,0.00%
545,2633.0,371,271,73.05%,254,68.46%,273,73.58%,2,0.54%,17,4.58%
546,9999.0,10,0,0.00%,0,0.00%,0,0.00%,0,0.00%,0,0.00%
547,2649.0,115,59,51.30%,52,45.22%,61,53.04%,2,1.74%,7,6.09%
548,9999.0,5,1,20.00%,1,20.00%,2,40.00%,1,20.00%,0,0.00%
549,2658.0,299,152,50.84%,146,48.83%,159,53.18%,7,2.34%,6,2.01%
550,9999.0,3,1,33.33%,1,33.33%,1,33.33%,0,0.00%,0,0.00%
551,2663.0,352,238,67.61%,237,67.33%,241,68.47%,3,0.85%,1,0.28%
552,2675.0,121,83,68.60%,83,68.60%,90,74.38%,7,5.79%,0,0.00%
553,2680.0,93,67,72.04%,66,70.97%,72,77.42%,5,5.38%,1,1.08%
554,4940.0,134,52,38.81%,52,38.81%,58,43.28%,6,4.48%,0,0.00%
555,2686.0,115,88,76.52%,84,73.04%,92,80.00%,4,3.48%,4,3.48%
556,2689.0,101,94,93.07%,94,93.07%,95,94.06%,1,0.99%,0,0.00%
557,9999.0,1,0,0.00%,0,0.00%,1,100.00%,1,100.00%,0,0.00%
558,2704.0,160,115,71.88%,109,68.13%,117,73.13%,2,1.25%,6,3.75%
559,9999.0,22,3,13.64%,2,9.09%,3,13.64%,0,0.00%,1,4.55%
560,2708.0,85,67,78.82%,64,75.29%,69,81.18%,2,2.35%,3,3.53%
561,2712.0,42,31,73.81%,30,71.43%,34,80.95%,3,7.14%,1,2.38%
562,9999.0,3,1,33.33%,1,33.33%,1,33.33%,0,0.00%,0,0.00%
563,2721.0,92,62,67.39%,57,61.96%,62,67.39%,0,0.00%,5,5.43%
564,9999.0,2,0,0.00%,0,0.00%,0,0.00%,0,0.00%,0,0.00%
565,2725.0,117,77,65.81%,77,65.81%,83,70.94%,6,5.13%,0,0.00%
566,9999.0,1,0,0.00%,0,0.00%,0,0.00%,0,0.00%,0,0.00%
567,4800.0,318,222,69.81%,215,67.61%,240,75.47%,18,5.66%,7,2.20%
568,2740.0,174,102,58.62%,102,58.62%,109,62.64%,7,4.02%,0,0.00%
569,9999.0,2,0,0.00%,0,0.00%,0,0.00%,0,0.00%,0,0.00%
570,5155.0,218,101,46.33%,99,45.41%,105,48.17%,4,1.83%,2,0.92%
571,9999.0,12,1,8.33%,1,8.33%,1,8.33%,0,0.00%,0,0.00%
572,2760.0,185,110,59.46%,96,51.89%,110,59.46%,0,0.00%,14,7.57%
573,9999.0,5,0,0.00%,0,0.00%,0,0.00%,0,0.00%,0,0.00%
574,2766.0,261,195,74.71%,195,74.71%,196,75.10%,1,0.38%,0,0.00%
575,9999.0,1,0,0.00%,0,0.00%,0,0.00%,0,0.00%,0,0.00%
576,2794.0,603,313,51.91%,301,49.92%,330,54.73%,17,2.82%,12,1.99%
577,2795.0,436,281,64.45%,272,62.39%,294,67.43%,13,2.98%,9,2.06%
578,9999.0,129,46,35.66%,45,34.88%,59,45.74%,13,10.08%,1,0.78%
579,2798.0,123,78,63.41%,75,60.98%,79,64.23%,1,0.81%,3,2.44%
580,9999.0,4,1,25.00%,1,25.00%,1,25.00%,0,0.00%,0,0.00%
581,2809.0,649,521,80.28%,516,79.51%,527,81.20%,6,0.92%,5,0.77%
582,8401.0,29,26,89.66%,26,89.66%,28,96.55%,2,6.90%,0,0.00%
583,2818.0,127,91,71.65%,88,69.29%,92,72.44%,1,0.79%,3,2.36%
584,9999.0,1,0,0.00%,0,0.00%,0,0.00%,0,0.00%,0,0.00%
585,2821.0,192,154,80.21%,152,79.17%,156,81.25%,2,1.04%,2,1.04%
586,9999.0,5,2,40.00%,2,40.00%,2,40.00%,0,0.00%,0,0.00%
587,2829.0,775,659,85.03%,658,84.90%,661,85.29%,2,0.26%,1,0.13%
588,9999.0,6,3,50.00%,3,50.00%,3,50.00%,0,0.00%,0,0.00%
589,8371.0,43,22,51.16%,22,51.16%,22,51.16%,0,0.00%,0,0.00%
590,2833.0,138,103,74.64%,103,74.64%,107,77.54%,4,2.90%,0,0.00%
591,9999.0,5,3,60.00%,3,60.00%,3,60.00%,0,0.00%,0,0.00%
592,2839.0,254,194,76.38%,194,76.38%,210,82.68%,16,6.30%,0,0.00%
593,9999.0,2,0,0.00%,0,0.00%,0,0.00%,0,0.00%,0,0.00%
594,2848.0,348,260,74.71%,256,73.56%,260,74.71%,0,0.00%,4,1.15%
595,9999.0,4,0,0.00%,0,0.00%,0,0.00%,0,0.00%,0,0.00%
596,8125.0,61,57,93.44%,57,93.44%,58,95.08%,1,1.64%,0,0.00%
597,2860.0,220,185,84.09%,182,82.73%,185,84.09%,0,0.00%,3,1.36%
598,9999.0,3,0,0.00%,0,0.00%,0,0.00%,0,0.00%,0,0.00%
599,2869.0,207,183,88.41%,183,88.41%,185,89.37%,2,0.97%,0,0.00%
600,9999.0,1,0,0.00%,0,0.00%,0,0.00%,0,0.00%,0,0.00%
601,5242.0,160,103,64.38%,103,64.38%,106,66.25%,3,1.88%,0,0.00%
602,9999.0,12,0,0.00%,0,0.00%,0,0.00%,0,0.00%,0,0.00%
603,2891.0,140,108,77.14%,108,77.14%,108,77.14%,0,0.00%,0,0.00%
604,9999.0,7,1,14.29%,1,14.29%,1,14.29%,0,0.00%,0,0.00%
605,7348.0,748,481,64.30%,472,63.10%,491,65.64%,10,1.34%,9,1.20%
606,2924.0,117,89,76.07%,89,76.07%,90,76.92%,1,0.85%,0,0.00%
607,2958.0,74,51,68.92%,51,68.92%,56,75.68%,5,6.76%,0,0.00%
608,5058.0,236,201,85.17%,201,85.17%,208,88.14%,7,2.97%,0,0.00%
609,5059.0,106,50,47.17%,48,45.28%,51,48.11%,1,0.94%,2,1.89%
610,3007.0,193,145,75.13%,142,73.58%,145,75.13%,0,0.00%,3,1.55%
611,3008.0,126,70,55.56%,70,55.56%,72,57.14%,2,1.59%,0,0.00%
612,3009.0,167,130,77.84%,124,74.25%,133,79.64%,3,1.80%,6,3.59%
613,9999.0,32,7,21.88%,7,21.88%,7,21.88%,0,0.00%,0,0.00%
614,6390.0,140,113,80.71%,110,78.57%,114,81.43%,1,0.71%,3,2.14%
615,6391.0,286,201,70.28%,193,67.48%,202,70.63%,1,0.35%,8,2.80%
616,9999.0,1,0,0.00%,0,0.00%,0,0.00%,0,0.00%,0,0.00%
617,6364.0,118,68,57.63%,67,56.78%,70,59.32%,2,1.69%,1,0.85%
618,3034.0,160,106,66.25%,101,63.13%,106,66.25%,0,0.00%,5,3.13%
619,4828.0,110,80,72.73%,80,72.73%,83,75.45%,3,2.73%,0,0.00%
620,3040.0,49,30,61.22%,25,51.02%,32,65.31%,2,4.08%,5,10.20%
621,3045.0,161,120,74.53%,120,74.53%,121,75.16%,1,0.62%,0,0.00%
622,3048.0,66,53,80.30%,53,80.30%,53,80.30%,0,0.00%,0,0.00%
623,9999.0,4,0,0.00%,0,0.00%,0,0.00%,0,0.00%,0,0.00%
624,3056.0,85,56,65.88%,56,65.88%,57,67.06%,1,1.18%,0,0.00%
625,6368.0,334,153,45.81%,153,45.81%,153,45.81%,0,0.00%,0,0.00%
626,9999.0,2,0,0.00%,0,0.00%,0,0.00%,0,0.00%,0,0.00%
627,4691.0,169,99,58.58%,97,57.40%,104,61.54%,5,2.96%,2,1.18%
628,9999.0,5,0,0.00%,0,0.00%,4,80.00%,4,80.00%,0,0.00%
629,5245.0,78,51,65.38%,51,65.38%,51,65.38%,0,0.00%,0,0.00%
630,3107.0,44,31,70.45%,29,65.91%,33,75.00%,2,4.55%,2,4.55%
631,3111.0,59,34,57.63%,32,54.24%,35,59.32%,1,1.69%,2,3.39%
632,3117.0,63,34,53.97%,31,49.21%,35,55.56%,1,1.59%,3,4.76%
633,6122.0,44,28,63.64%,24,54.55%,28,63.64%,0,0.00%,4,9.09%
634,5248.0,46,31,67.39%,21,45.65%,32,69.57%,1,2.17%,10,21.74%
635,3137.0,119,88,73.95%,85,71.43%,99,83.19%,11,9.24%,3,2.52%
636,7506.0,46,0,0.00%,0,0.00%,6,13.04%,6,13.04%,0,0.00%
637,3145.0,153,117,76.47%,114,74.51%,118,77.12%,1,0.65%,3,1.96%
638,6125.0,29,12,41.38%,9,31.03%,13,44.83%,1,3.45%,3,10.34%
639,3150.0,159,128,80.50%,125,78.62%,128,80.50%,0,0.00%,3,1.89%
640,6126.0,27,17,62.96%,17,62.96%,22,81.48%,5,18.52%,0,0.00%
641,3155.0,103,64,62.14%,64,62.14%,65,63.11%,1,0.97%,0,0.00%
642,3158.0,108,70,64.81%,67,62.04%,72,66.67%,2,1.85%,3,2.78%
643,3165.0,105,77,73.33%,72,68.57%,77,73.33%,0,0.00%,5,4.76%
644,8093.0,125,77,61.60%,77,61.60%,77,61.60%,0,0.00%,0,0.00%
645,9999.0,1,0,0.00%,0,0.00%,0,0.00%,0,0.00%,0,0.00%
646,3124.0,95,64,67.37%,63,66.32%,69,72.63%,5,5.26%,1,1.05%
647,6129.0,73,51,69.86%,43,58.90%,51,69.86%,0,0.00%,8,10.96%
648,9999.0,1,0,0.00%,0,0.00%,0,0.00%,0,0.00%,0,0.00%
649,8187.0,420,206,49.05%,193,45.95%,213,50.71%,7,1.67%,13,3.10%
650,9999.0,1,0,0.00%,0,0.00%,0,0.00%,0,0.00%,0,0.00%
651,7866.0,11,10,90.91%,10,90.91%,10,90.91%,0,0.00%,0,0.00%
652,6935.0,326,244,74.85%,152,46.63%,261,80.06%,17,5.21%,92,28.22%
653,7641.0,251,160,63.75%,160,63.75%,164,65.34%,4,1.59%,0,0.00%
654,9999.0,5,0,0.00%,0,0.00%,0,0.00%,0,0.00%,0,0.00%
655,3210.0,410,331,80.73%,323,78.78%,338,82.44%,7,1.71%,8,1.95%
656,3216.0,337,265,78.64%,262,77.74%,266,78.93%,1,0.30%,3,0.89%
657,7738.0,411,209,50.85%,209,50.85%,217,52.80%,8,1.95%,0,0.00%
658,8010.0,2,0,0.00%,0,0.00%,0,0.00%,0,0.00%,0,0.00%
659,9999.0,8,0,0.00%,0,0.00%,0,0.00%,0,0.00%,0,0.00%
660,3224.0,388,193,49.74%,191,49.23%,193,49.74%,0,0.00%,2,0.52%
661,9999.0,1,0,0.00%,0,0.00%,0,0.00%,0,0.00%,0,0.00%
662,7687.0,201,96,47.76%,95,47.26%,110,54.73%,14,6.97%,1,0.50%
663,3241.0,562,481,85.59%,479,85.23%,481,85.59%,0,0.00%,2,0.36%
664,3260.0,331,270,81.57%,267,80.66%,280,84.59%,10,3.02%,3,0.91%
665,9999.0,2,0,0.00%,0,0.00%,0,0.00%,0,0.00%,0,0.00%
666,3333.0,351,308,87.75%,306,87.18%,312,88.89%,4,1.14%,2,0.57%
667,9999.0,9,0,0.00%,0,0.00%,0,0.00%,0,0.00%,0,0.00%
668,3272.0,373,331,88.74%,330,88.47%,332,89.01%,1,0.27%,1,0.27%
669,9999.0,4,1,25.00%,1,25.00%,1,25.00%,0,0.00%,0,0.00%
670,8049.0,38,38,100.00%,38,100.00%,38,100.00%,0,0.00%,0,0.00%
671,3295.0,357,333,93.28%,333,93.28%,337,94.40%,4,1.12%,0,0.00%
672,3296.0,287,269,93.73%,269,93.73%,272,94.77%,3,1.05%,0,0.00%
673,9999.0,9,0,0.00%,0,0.00%,0,0.00%,0,0.00%,0,0.00%
674,4960.0,186,178,95.70%,178,95.70%,178,95.70%,0,0.00%,0,0.00%
675,3305.0,395,357,90.38%,357,90.38%,360,91.14%,3,0.76%,0,0.00%
676,9999.0,1,1,100.00%,1,100.00%,1,100.00%,0,0.00%,0,0.00%
677,6729.0,292,221,75.68%,217,74.32%,221,75.68%,0,0.00%,4,1.37%
678,6998.0,67,39,58.21%,35,52.24%,39,58.21%,0,0.00%,4,5.97%
679,9999.0,11,0,0.00%,0,0.00%,0,0.00%,0,0.00%,0,0.00%
680,5345.0,974,830,85.22%,829,85.11%,841,86.34%,11,1.13%,1,0.10%
681,9999.0,4,0,0.00%,0,0.00%,0,0.00%,0,0.00%,0,0.00%
682,3328.0,417,361,86.57%,357,85.61%,362,86.81%,1,0.24%,4,0.96%
683,9999.0,1,0,0.00%,0,0.00%,0,0.00%,0,0.00%,0,0.00%
684,3338.0,260,199,76.54%,197,75.77%,199,76.54%,0,0.00%,2,0.77%
685,9999.0,4,0,0.00%,0,0.00%,0,0.00%,0,0.00%,0,0.00%
686,3348.0,148,106,71.62%,101,68.24%,106,71.62%,0,0.00%,5,3.38%
687,9999.0,3,0,0.00%,0,0.00%,0,0.00%,0,0.00%,0,0.00%
688,3354.0,536,426,79.48%,426,79.48%,436,81.34%,10,1.87%,0,0.00%
689,9999.0,17,1,5.88%,1,5.88%,1,5.88%,0,0.00%,0,0.00%
690,3376.0,136,121,88.97%,121,88.97%,122,89.71%,1,0.74%,0,0.00%
691,9999.0,1,0,0.00%,0,0.00%,0,0.00%,0,0.00%,0,0.00%
692,3367.0,641,559,87.21%,557,86.90%,566,88.30%,7,1.09%,2,0.31%
693,9999.0,3,0,0.00%,0,0.00%,0,0.00%,0,0.00%,0,0.00%
694,5078.0,369,350,94.85%,344,93.22%,352,95.39%,2,0.54%,6,1.63%
695,9999.0,2,0,0.00%,0,0.00%,0,0.00%,0,0.00%,0,0.00%
696,3395.0,255,220,86.27%,217,85.10%,220,86.27%,0,0.00%,3,1.18%
697,9999.0,17,3,17.65%,3,17.65%,3,17.65%,0,0.00%,0,0.00%
698,3401.0,238,192,80.67%,192,80.67%,194,81.51%,2,0.84%,0,0.00%
699,5081.0,222,146,65.77%,146,65.77%,148,66.67%,2,0.90%,0,0.00%
700,9999.0,6,0,0.00%,0,0.00%,0,0.00%,0,0.00%,0,0.00%
701,3247.0,337,313,92.88%,312,92.58%,315,93.47%,2,0.59%,1,0.30%
702,9999.0,17,2,11.76%,2,11.76%,3,17.65%,1,5.88%,0,0.00%
703,7858.0,752,345,45.88%,329,43.75%,398,52.93%,53,7.05%,16,2.13%
704,9999.0,1,0,0.00%,0,0.00%,0,0.00%,0,0.00%,0,0.00%
705,3425.0,153,109,71.24%,108,70.59%,116,75.82%,7,4.58%,1,0.65%
706,7681.0,71,68,95.77%,67,94.37%,68,95.77%,0,0.00%,1,1.41%
707,3434.0,213,144,67.61%,144,67.61%,144,67.61%,0,0.00%,0,0.00%
708,3465.0,632,478,75.63%,465,73.58%,487,77.06%,9,1.42%,13,2.06%
709,4957.0,435,344,79.08%,340,78.16%,349,80.23%,5,1.15%,4,0.92%
710,9999.0,10,4,40.00%,4,40.00%,4,40.00%,0,0.00%,0,0.00%
711,7634.0,149,128,85.91%,128,85.91%,131,87.92%,3,2.01%,0,0.00%
712,3482.0,613,487,79.45%,484,78.96%,503,82.06%,16,2.61%,3,0.49%
713,3495.0,372,333,89.52%,329,88.44%,335,90.05%,2,0.54%,4,1.08%
714,3505.0,418,329,78.71%,325,77.75%,333,79.67%,4,0.96%,4,0.96%
715,6439.0,125,86,68.80%,81,64.80%,88,70.40%,2,1.60%,5,4.00%
716,5352.0,189,160,84.66%,160,84.66%,160,84.66%,0,0.00%,0,0.00%
717,3522.0,167,143,85.63%,141,84.43%,144,86.23%,1,0.60%,2,1.20%
718,9999.0,2,0,0.00%,0,0.00%,0,0.00%,0,0.00%,0,0.00%
719,3532.0,90,52,57.78%,48,53.33%,58,64.44%,6,6.67%,4,4.44%
720,9999.0,3,0,0.00%,0,0.00%,0,0.00%,0,0.00%,0,0.00%
721,3541.0,151,79,52.32%,79,52.32%,80,52.98%,1,0.66%,0,0.00%
722,9999.0,3,0,0.00%,0,0.00%,0,0.00%,0,0.00%,0,0.00%
723,6936.0,99,70,70.71%,69,69.70%,71,71.72%,1,1.01%,1,1.01%
724,9999.0,1,0,0.00%,0,0.00%,0,0.00%,0,0.00%,0,0.00%
725,7893.0,127,74,58.27%,72,56.69%,75,59.06%,1,0.79%,2,1.57%
726,3569.0,173,105,60.69%,104,60.12%,105,60.69%,0,0.00%,1,0.58%
727,5103.0,120,70,58.33%,70,58.33%,77,64.17%,7,5.83%,0,0.00%
728,6341.0,50,37,74.00%,37,74.00%,39,78.00%,2,4.00%,0,0.00%
729,7930.0,69,51,73.91%,50,72.46%,51,73.91%,0,0.00%,1,1.45%
730,3589.0,115,67,58.26%,67,58.26%,67,58.26%,0,0.00%,0,0.00%
731,3596.0,163,88,53.99%,87,53.37%,89,54.60%,1,0.61%,1,0.61%
732,7744.0,45,36,80.00%,34,75.56%,37,82.22%,1,2.22%,2,4.44%
733,8083.0,37,35,94.59%,34,91.89%,37,100.00%,2,5.41%,1,2.70%
734,7678.0,66,52,78.79%,52,78.79%,56,84.85%,4,6.06%,0,0.00%
735,7737.0,159,81,50.94%,81,50.94%,104,65.41%,23,14.47%,0,0.00%
736,7777.0,63,40,63.49%,40,63.49%,42,66.67%,2,3.17%,0,0.00%
737,7909.0,116,102,87.93%,100,86.21%,107,92.24%,5,4.31%,2,1.72%
738,7910.0,92,73,79.35%,73,79.35%,73,79.35%,0,0.00%,0,0.00%
739,8216.0,22,13,59.09%,13,59.09%,17,77.27%,4,18.18%,0,0.00%
740,7510.0,133,98,73.68%,98,73.68%,104,78.20%,6,4.51%,0,0.00%
741,7513.0,139,14,10.07%,12,8.63%,20,14.39%,6,4.32%,2,1.44%
742,7540.0,118,70,59.32%,70,59.32%,73,61.86%,3,2.54%,0,0.00%
743,7542.0,125,104,83.20%,104,83.20%,106,84.80%,2,1.60%,0,0.00%
744,7546.0,55,52,94.55%,51,92.73%,52,94.55%,0,0.00%,1,1.82%
745,7574.0,102,89,87.25%,87,85.29%,90,88.24%,1,0.98%,2,1.96%
746,7578.0,116,107,92.24%,107,92.24%,107,92.24%,0,0.00%,0,0.00%
747,7582.0,75,73,97.33%,70,93.33%,73,97.33%,0,0.00%,3,4.00%
748,7586.0,95,91,95.79%,90,94.74%,93,97.89%,2,2.11%,1,1.05%
749,7587.0,100,78,78.00%,78,78.00%,78,78.00%,0,0.00%,0,0.00%
750,7588.0,60,41,68.33%,41,68.33%,45,75.00%,4,6.67%,0,0.00%
751,7647.0,207,200,96.62%,200,96.62%,202,97.58%,2,0.97%,0,0.00%
752,7649.0,190,178,93.68%,178,93.68%,180,94.74%,2,1.05%,0,0.00%
753,7665.0,157,102,64.97%,102,64.97%,111,70.70%,9,5.73%,0,0.00%
754,7666.0,253,198,78.26%,198,78.26%,210,83.00%,12,4.74%,0,0.00%
755,8205.0,432,238,55.09%,236,54.63%,280,64.81%,42,9.72%,2,0.46%
756,7672.0,111,81,72.97%,81,72.97%,81,72.97%,0,0.00%,0,0.00%
757,8207.0,234,152,64.96%,152,64.96%,177,75.64%,25,10.68%,0,0.00%
758,8217.0,12,0,0.00%,0,0.00%,0,0.00%,0,0.00%,0,0.00%
759,8358.0,112,97,86.61%,97,86.61%,104,92.86%,7,6.25%,0,0.00%
760,3728.0,10,0,0.00%,0,0.00%,0,0.00%,0,0.00%,0,0.00%
761,3808.0,106,104,98.11%,104,98.11%,104,98.11%,0,0.00%,0,0.00%
762,3816.0,181,109,60.22%,98,54.14%,114,62.98%,5,2.76%,11,6.08%
763,3818.0,149,98,65.77%,92,61.74%,101,67.79%,3,2.01%,6,4.03%
764,3841.0,83,51,61.45%,48,57.83%,54,65.06%,3,3.61%,3,3.61%
765,3842.0,88,55,62.50%,44,50.00%,57,64.77%,2,2.27%,11,12.50%
766,3843.0,232,202,87.07%,199,85.78%,202,87.07%,0,0.00%,3,1.29%
767,3844.0,100,78,78.00%,76,76.00%,82,82.00%,4,4.00%,2,2.00%
768,3845.0,252,181,71.83%,167,66.27%,183,72.62%,2,0.79%,14,5.56%
769,3847.0,138,72,52.17%,64,46.38%,80,57.97%,8,5.80%,8,5.80%
770,3848.0,548,408,74.45%,406,74.09%,409,74.64%,1,0.18%,2,0.36%
771,3849.0,160,83,51.88%,71,44.38%,86,53.75%,3,1.88%,12,7.50%
772,3850.0,222,111,50.00%,94,42.34%,114,51.35%,3,1.35%,17,7.66%
773,3851.0,82,31,37.80%,25,30.49%,31,37.80%,0,0.00%,6,7.32%
774,3855.0,679,461,67.89%,448,65.98%,477,70.25%,16,2.36%,13,1.91%
775,3857.0,78,51,65.38%,46,58.97%,54,69.23%,3,3.85%,5,6.41%
776,3859.0,88,41,46.59%,39,44.32%,42,47.73%,1,1.14%,2,2.27%
777,3860.0,75,47,62.67%,43,57.33%,50,66.67%,3,4.00%,4,5.33%
778,3861.0,80,9,11.25%,9,11.25%,9,11.25%,0,0.00%,0,0.00%
779,6527.0,266,191,71.80%,179,67.29%,196,73.68%,5,1.88%,12,4.51%
780,6548.0,43,33,76.74%,33,76.74%,34,79.07%,1,2.33%,0,0.00%
781,6675.0,89,38,42.70%,34,38.20%,43,48.31%,5,5.62%,4,4.49%
782,6822.0,160,126,78.75%,120,75.00%,129,80.63%,3,1.88%,6,3.75%
783,6996.0,138,112,81.16%,112,81.16%,113,81.88%,1,0.72%,0,0.00%
784,7023.0,150,141,94.00%,140,93.33%,142,94.67%,1,0.67%,1,0.67%
785,7070.0,103,82,79.61%,82,79.61%,85,82.52%,3,2.91%,0,0.00%
786,7072.0,119,82,68.91%,70,58.82%,84,70.59%,2,1.68%,12,10.08%
787,7229.0,69,48,69.57%,47,68.12%,49,71.01%,1,1.45%,1,1.45%
788,7245.0,74,39,52.70%,37,50.00%,43,58.11%,4,5.41%,2,2.70%
789,7255.0,40,14,35.00%,13,32.50%,14,35.00%,0,0.00%,1,2.50%
790,7664.0,59,51,86.44%,51,86.44%,52,88.14%,1,1.69%,0,0.00%
791,7780.0,77,53,68.83%,51,66.23%,54,70.13%,1,1.30%,2,2.60%
792,7782.0,91,81,89.01%,77,84.62%,82,90.11%,1,1.10%,4,4.40%
793,7808.0,37,31,83.78%,28,75.68%,31,83.78%,0,0.00%,3,8.11%
794,7811.0,68,45,66.18%,44,64.71%,46,67.65%,1,1.47%,1,1.47%
795,7813.0,115,75,65.22%,65,56.52%,79,68.70%,4,3.48%,10,8.70%
796,7815.0,81,57,70.37%,53,65.43%,57,70.37%,0,0.00%,4,4.94%
797,7850.0,60,34,56.67%,32,53.33%,37,61.67%,3,5.00%,2,3.33%
798,7852.0,99,57,57.58%,54,54.55%,60,60.61%,3,3.03%,3,3.03%
799,7855.0,74,51,68.92%,47,63.51%,53,71.62%,2,2.70%,4,5.41%
800,7903.0,82,70,85.37%,66,80.49%,71,86.59%,1,1.22%,4,4.88%
801,7904.0,212,185,87.26%,182,85.85%,188,88.68%,3,1.42%,3,1.42%
802,7905.0,89,79,88.76%,78,87.64%,80,89.89%,1,1.12%,1,1.12%
803,7906.0,122,79,64.75%,79,64.75%,80,65.57%,1,0.82%,0,0.00%
804,8039.0,146,137,93.84%,130,89.04%,140,95.89%,3,2.05%,7,4.79%
805,8293.0,63,43,68.25%,41,65.08%,44,69.84%,1,1.59%,2,3.17%
806,8298.0,36,20,55.56%,17,47.22%,21,58.33%,1,2.78%,3,8.33%
807,8328.0,49,15,30.61%,14,28.57%,16,32.65%,1,2.04%,1,2.04%
808,8329.0,49,40,81.63%,38,77.55%,41,83.67%,1,2.04%,2,4.08%
809,8330.0,123,109,88.62%,107,86.99%,110,89.43%,1,0.81%,2,1.63%
810,8331.0,57,34,59.65%,32,56.14%,34,59.65%,0,0.00%,2,3.51%
811,8332.0,66,41,62.12%,35,53.03%,41,62.12%,0,0.00%,6,9.09%
812,8385.0,6,0,0.00%,0,0.00%,0,0.00%,0,0.00%,0,0.00%
813,8386.0,16,0,0.00%,0,0.00%,0,0.00%,0,0.00%,0,0.00%
814,8388.0,90,17,18.89%,13,14.44%,20,22.22%,3,3.33%,4,4.44%
815,9999.0,685,63,9.20%,48,7.01%,69,10.07%,6,0.88%,15,2.19%
816,8195.0,108,0,0.00%,0,0.00%,0,0.00%,0,0.00%,0,0.00%
817,7961.0,94,62,65.96%,62,65.96%,66,70.21%,4,4.26%,0,0.00%
818,8127.0,55,52,94.55%,52,94.55%,52,94.55%,0,0.00%,0,0.00%
819,8148.0,45,27,60.00%,27,60.00%,35,77.78%,8,17.78%,0,0.00%
820,7981.0,87,75,86.21%,74,85.06%,77,88.51%,2,2.30%,1,1.15%
821,8126.0,89,68,76.40%,68,76.40%,73,82.02%,5,5.62%,0,0.00%
822,4310.0,274,175,63.87%,171,62.41%,182,66.42%,7,2.55%,4,1.46%
823,5261.0,393,280,71.25%,280,71.25%,289,73.54%,9,2.29%,0,0.00%
824,6222.0,12,5,41.67%,5,41.67%,5,41.67%,0,0.00%,0,0.00%
825,3869.0,61,41,67.21%,41,67.21%,41,67.21%,0,0.00%,0,0.00%
826,9999.0,1,0,0.00%,0,0.00%,0,0.00%,0,0.00%,0,0.00%
827,6223.0,14,6,42.86%,5,35.71%,8,57.14%,2,14.29%,1,7.14%
828,3875.0,36,19,52.78%,19,52.78%,19,52.78%,0,0.00%,0,0.00%
829,3877.0,34,21,61.76%,21,61.76%,21,61.76%,0,0.00%,0,0.00%
830,9999.0,1,0,0.00%,0,0.00%,0,0.00%,0,0.00%,0,0.00%
831,3891.0,205,145,70.73%,132,64.39%,147,71.71%,2,0.98%,13,6.34%
832,8403.0,82,56,68.29%,56,68.29%,61,74.39%,5,6.10%,0,0.00%
833,9999.0,1,0,0.00%,0,0.00%,0,0.00%,0,0.00%,0,0.00%
834,6583.0,66,46,69.70%,43,65.15%,48,72.73%,2,3.03%,3,4.55%
835,8161.0,11,5,45.45%,5,45.45%,5,45.45%,0,0.00%,0,0.00%
836,3883.0,123,69,56.10%,69,56.10%,70,56.91%,1,0.81%,0,0.00%
837,3910.0,126,63,50.00%,61,48.41%,72,57.14%,9,7.14%,2,1.59%
838,3924.0,214,138,64.49%,123,57.48%,140,65.42%,2,0.93%,15,7.01%
839,9999.0,6,0,0.00%,0,0.00%,0,0.00%,0,0.00%,0,0.00%
840,3940.0,78,47,60.26%,47,60.26%,49,62.82%,2,2.56%,0,0.00%
841,5264.0,104,66,63.46%,66,63.46%,66,63.46%,0,0.00%,0,0.00%
842,5070.0,157,136,86.62%,135,85.99%,137,87.26%,1,0.64%,1,0.64%
843,3957.0,71,46,64.79%,46,64.79%,54,76.06%,8,11.27%,0,0.00%
844,3914.0,68,36,52.94%,29,42.65%,42,61.76%,6,8.82%,7,10.29%
845,9999.0,1,0,0.00%,0,0.00%,0,0.00%,0,0.00%,0,0.00%
846,3962.0,175,68,38.86%,67,38.29%,69,39.43%,1,0.57%,1,0.57%
847,9999.0,2,0,0.00%,0,0.00%,0,0.00%,0,0.00%,0,0.00%
848,3969.0,147,108,73.47%,108,73.47%,108,73.47%,0,0.00%,0,0.00%
849,6207.0,69,35,50.72%,35,50.72%,46,66.67%,11,15.94%,0,0.00%
850,3978.0,73,55,75.34%,51,69.86%,56,76.71%,1,1.37%,4,5.48%
851,3994.0,64,39,60.94%,37,57.81%,39,60.94%,0,0.00%,2,3.13%
852,9999.0,1,0,0.00%,0,0.00%,0,0.00%,0,0.00%,0,0.00%
853,3988.0,93,49,52.69%,48,51.61%,51,54.84%,2,2.15%,1,1.08%
854,6210.0,53,28,52.83%,28,52.83%,28,52.83%,0,0.00%,0,0.00%
855,4002.0,21,10,47.62%,10,47.62%,11,52.38%,1,4.76%,0,0.00%
856,4006.0,30,17,56.67%,17,56.67%,17,56.67%,0,0.00%,0,0.00%
857,6800.0,23,11,47.83%,11,47.83%,12,52.17%,1,4.35%,0,0.00%
858,8274.0,187,103,55.08%,91,48.66%,108,57.75%,5,2.67%,12,6.42%
859,6216.0,26,12,46.15%,12,46.15%,12,46.15%,0,0.00%,0,0.00%
860,4026.0,86,57,66.28%,56,65.12%,63,73.26%,6,6.98%,1,1.16%
861,9999.0,3,0,0.00%,0,0.00%,0,0.00%,0,0.00%,0,0.00%
862,4030.0,41,23,56.10%,23,56.10%,24,58.54%,1,2.44%,0,0.00%
863,4034.0,66,46,69.70%,42,63.64%,46,69.70%,0,0.00%,4,6.06%
864,6418.0,96,55,57.29%,54,56.25%,55,57.29%,0,0.00%,1,1.04%
865,6419.0,52,30,57.69%,30,57.69%,32,61.54%,2,3.85%,0,0.00%
866,9999.0,1,0,0.00%,0,0.00%,0,0.00%,0,0.00%,0,0.00%
867,4044.0,127,82,64.57%,74,58.27%,83,65.35%,1,0.79%,8,6.30%
868,4049.0,67,42,62.69%,42,62.69%,48,71.64%,6,8.96%,0,0.00%
869,4054.0,53,30,56.60%,30,56.60%,31,58.49%,1,1.89%,0,0.00%
870,9999.0,3,0,0.00%,0,0.00%,0,0.00%,0,0.00%,0,0.00%
871,4058.0,50,26,52.00%,26,52.00%,26,52.00%,0,0.00%,0,0.00%
872,6373.0,83,55,66.27%,55,66.27%,59,71.08%,4,4.82%,0,0.00%
873,4064.0,45,27,60.00%,27,60.00%,28,62.22%,1,2.22%,0,0.00%
874,4068.0,85,45,52.94%,45,52.94%,48,56.47%,3,3.53%,0,0.00%
875,4080.0,107,77,71.96%,72,67.29%,79,73.83%,2,1.87%,5,4.67%
876,4085.0,172,146,84.88%,146,84.88%,146,84.88%,0,0.00%,0,0.00%
877,4091.0,157,80,50.96%,78,49.68%,82,52.23%,2,1.27%,2,1.27%
878,4098.0,89,48,53.93%,48,53.93%,57,64.04%,9,10.11%,0,0.00%
879,4106.0,136,81,59.56%,80,58.82%,87,63.97%,6,4.41%,1,0.74%
880,9999.0,10,0,0.00%,0,0.00%,0,0.00%,0,0.00%,0,0.00%
881,4931.0,143,76,53.15%,72,50.35%,79,55.24%,3,2.10%,4,2.80%
882,9999.0,16,0,0.00%,0,0.00%,0,0.00%,0,0.00%,0,0.00%
883,1668.0,135,70,51.85%,64,47.41%,76,56.30%,6,4.44%,6,4.44%
884,4126.0,64,36,56.25%,31,48.44%,36,56.25%,0,0.00%,5,7.81%
885,7833.0,21,17,80.95%,17,80.95%,17,80.95%,0,0.00%,0,0.00%
886,4135.0,65,33,50.77%,33,50.77%,34,52.31%,1,1.54%,0,0.00%
887,4143.0,70,41,58.57%,39,55.71%,45,64.29%,4,5.71%,2,2.86%
888,4146.0,44,19,43.18%,14,31.82%,20,45.45%,1,2.27%,5,11.36%
889,4149.0,178,103,57.87%,97,54.49%,108,60.67%,5,2.81%,6,3.37%
890,4165.0,35,21,60.00%,19,54.29%,21,60.00%,0,0.00%,2,5.71%
891,4188.0,80,60,75.00%,54,67.50%,60,75.00%,0,0.00%,6,7.50%
892,9999.0,1,0,0.00%,0,0.00%,0,0.00%,0,0.00%,0,0.00%
893,4181.0,73,41,56.16%,37,50.68%,41,56.16%,0,0.00%,4,5.48%
894,4195.0,103,70,67.96%,70,67.96%,70,67.96%,0,0.00%,0,0.00%
895,9999.0,3,0,0.00%,0,0.00%,0,0.00%,0,0.00%,0,0.00%
896,4203.0,87,63,72.41%,61,70.11%,68,78.16%,5,5.75%,2,2.30%
897,4217.0,386,314,81.35%,306,79.27%,315,81.61%,1,0.26%,8,2.07%
898,9999.0,6,0,0.00%,0,0.00%,0,0.00%,0,0.00%,0,0.00%
899,4715.0,98,64,65.31%,61,62.24%,64,65.31%,0,0.00%,3,3.06%
900,9999.0,1,1,100.00%,1,100.00%,1,100.00%,0,0.00%,0,0.00%
901,4235.0,96,76,79.17%,70,72.92%,77,80.21%,1,1.04%,6,6.25%
902,9999.0,3,0,0.00%,0,0.00%,0,0.00%,0,0.00%,0,0.00%
903,4242.0,78,53,67.95%,50,64.10%,55,70.51%,2,2.56%,3,3.85%
904,4249.0,116,68,58.62%,57,49.14%,68,58.62%,0,0.00%,11,9.48%
905,9999.0,2,0,0.00%,0,0.00%,0,0.00%,0,0.00%,0,0.00%
906,5083.0,336,311,92.56%,311,92.56%,315,93.75%,4,1.19%,0,0.00%
907,9999.0,2,0,0.00%,0,0.00%,0,0.00%,0,0.00%,0,0.00%
908,7019.0,223,149,66.82%,146,65.47%,152,68.16%,3,1.35%,3,1.35%
909,9999.0,7,0,0.00%,0,0.00%,0,0.00%,0,0.00%,0,0.00%
910,6012.0,245,168,68.57%,160,65.31%,175,71.43%,7,2.86%,8,3.27%
911,9999.0,1,0,0.00%,0,0.00%,0,0.00%,0,0.00%,0,0.00%
912,4286.0,91,58,63.74%,58,63.74%,65,71.43%,7,7.69%,0,0.00%
913,9999.0,7,0,0.00%,0,0.00%,0,0.00%,0,0.00%,0,0.00%
914,4295.0,189,135,71.43%,135,71.43%,140,74.07%,5,2.65%,0,0.00%
915,9999.0,17,10,58.82%,10,58.82%,10,58.82%,0,0.00%,0,0.00%
916,6704.0,147,102,69.39%,97,65.99%,104,70.75%,2,1.36%,5,3.40%
917,4930.0,183,142,77.60%,135,73.77%,148,80.87%,6,3.28%,7,3.83%
918,4340.0,125,98,78.40%,95,76.00%,98,78.40%,0,0.00%,3,2.40%
919,9999.0,1,0,0.00%,0,0.00%,0,0.00%,0,0.00%,0,0.00%
920,4352.0,151,110,72.85%,101,66.89%,111,73.51%,1,0.66%,9,5.96%
921,9999.0,6,0,0.00%,0,0.00%,0,0.00%,0,0.00%,0,0.00%
922,4360.0,306,278,90.85%,278,90.85%,280,91.50%,2,0.65%,0,0.00%
923,7550.0,31,16,51.61%,16,51.61%,18,58.06%,2,6.45%,0,0.00%
924,4845.0,309,232,75.08%,226,73.14%,242,78.32%,10,3.24%,6,1.94%
925,9999.0,3,0,0.00%,0,0.00%,0,0.00%,0,0.00%,0,0.00%
926,4373.0,166,163,98.19%,136,81.93%,163,98.19%,0,0.00%,27,16.27%
927,9999.0,1,0,0.00%,0,0.00%,0,0.00%,0,0.00%,0,0.00%
928,4404.0,437,352,80.55%,345,78.95%,358,81.92%,6,1.37%,7,1.60%
929,9999.0,4,0,0.00%,0,0.00%,0,0.00%,0,0.00%,0,0.00%
930,8421.0,52,38,73.08%,33,63.46%,39,75.00%,1,1.92%,5,9.62%
931,9999.0,3,0,0.00%,0,0.00%,0,0.00%,0,0.00%,0,0.00%
932,4431.0,291,200,68.73%,194,66.67%,207,71.13%,7,2.41%,6,2.06%
933,4442.0,129,97,75.19%,96,74.42%,106,82.17%,9,6.98%,1,0.78%
934,6181.0,48,26,54.17%,22,45.83%,27,56.25%,1,2.08%,4,8.33%
935,9999.0,2,0,0.00%,0,0.00%,0,0.00%,0,0.00%,0,0.00%
936,4458.0,160,0,0.00%,0,0.00%,0,0.00%,0,0.00%,0,0.00%
937,8323.0,116,86,74.14%,77,66.38%,86,74.14%,0,0.00%,9,7.76%
938,4717.0,377,322,85.41%,316,83.82%,326,86.47%,4,1.06%,6,1.59%
939,9999.0,3,0,0.00%,0,0.00%,0,0.00%,0,0.00%,0,0.00%
940,6648.0,333,275,82.58%,274,82.28%,280,84.08%,5,1.50%,1,0.30%
941,9999.0,4,0,0.00%,0,0.00%,0,0.00%,0,0.00%,0,0.00%
942,6191.0,135,101,74.81%,101,74.81%,101,74.81%,0,0.00%,0,0.00%
943,9999.0,2,0,0.00%,0,0.00%,0,0.00%,0,0.00%,0,0.00%
944,4735.0,177,126,71.19%,116,65.54%,126,71.19%,0,0.00%,10,5.65%
945,9999.0,1,0,0.00%,0,0.00%,0,0.00%,0,0.00%,0,0.00%
946,5271.0,184,127,69.02%,124,67.39%,132,71.74%,5,2.72%,3,1.63%
947,4528.0,82,50,60.98%,50,60.98%,56,68.29%,6,7.32%,0,0.00%
948,9999.0,1,0,0.00%,0,0.00%,0,0.00%,0,0.00%,0,0.00%
949,4545.0,458,351,76.64%,336,73.36%,358,78.17%,7,1.53%,15,3.28%
950,9999.0,2,0,0.00%,0,0.00%,0,0.00%,0,0.00%,0,0.00%
951,4553.0,453,339,74.83%,339,74.83%,361,79.69%,22,4.86%,0,0.00%
952,9999.0,11,5,45.45%,5,45.45%,6,54.55%,1,9.09%,0,0.00%
953,4558.0,227,142,62.56%,138,60.79%,148,65.20%,6,2.64%,4,1.76%
954,9999.0,10,0,0.00%,0,0.00%,0,0.00%,0,0.00%,0,0.00%
955,4564.0,158,92,58.23%,88,55.70%,101,63.92%,9,5.70%,4,2.53%
956,9999.0,6,0,0.00%,0,0.00%,0,0.00%,0,0.00%,0,0.00%
957,4571.0,111,56,50.45%,56,50.45%,58,52.25%,2,1.80%,0,0.00%
958,9999.0,10,1,10.00%,1,10.00%,1,10.00%,0,0.00%,0,0.00%
959,7624.0,53,1,1.89%,1,1.89%,1,1.89%,0,0.00%,0,0.00%
960,4577.0,219,159,72.60%,158,72.15%,165,75.34%,6,2.74%,1,0.46%
961,9999.0,3,0,0.00%,0,0.00%,0,0.00%,0,0.00%,0,0.00%
962,4598.0,376,230,61.17%,218,57.98%,244,64.89%,14,3.72%,12,3.19%
963,9999.0,5,0,0.00%,0,0.00%,0,0.00%,0,0.00%,0,0.00%
964,4602.0,165,117,70.91%,108,65.45%,118,71.52%,1,0.61%,9,5.45%
965,9999.0,16,2,12.50%,2,12.50%,4,25.00%,2,12.50%,0,0.00%
966,4608.0,297,212,71.38%,210,70.71%,222,74.75%,10,3.37%,2,0.67%
967,9999.0,17,0,0.00%,0,0.00%,0,0.00%,0,0.00%,0,0.00%
968,4614.0,226,166,73.45%,162,71.68%,172,76.11%,6,2.65%,4,1.77%
969,9999.0,4,0,0.00%,0,0.00%,0,0.00%,0,0.00%,0,0.00%
970,4623.0,265,148,55.85%,141,53.21%,152,57.36%,4,1.51%,7,2.64%
971,9999.0,5,0,0.00%,0,0.00%,0,0.00%,0,0.00%,0,0.00%
972,6705.0,213,140,65.73%,124,58.22%,147,69.01%,7,3.29%,16,7.51%
973,9999.0,6,0,0.00%,0,0.00%,0,0.00%,0,0.00%,0,0.00%
974,4647.0,199,123,61.81%,113,56.78%,128,64.32%,5,2.51%,10,5.03%
975,9999.0,22,1,4.55%,1,4.55%,2,9.09%,1,4.55%,0,0.00%
976,5168.0,358,165,46.09%,154,43.02%,169,47.21%,4,1.12%,11,3.07%
977,4658.0,196,148,75.51%,148,75.51%,150,76.53%,2,1.02%,0,0.00%
978,9999.0,16,8,50.00%,6,37.50%,10,62.50%,2,12.50%,2,12.50%
979,1732.0,267,196,73.41%,196,73.41%,197,73.78%,1,0.37%,0,0.00%
980,4704.0,285,200,70.18%,200,70.18%,207,72.63%,7,2.46%,0,0.00%
981,9999.0,2,0,0.00%,0,0.00%,0,0.00%,0,0.00%,0,0.00%
982,6345.0,247,149,60.32%,144,58.30%,149,60.32%,0,0.00%,5,2.02%
983,9999.0,4,0,0.00%,0,0.00%,0,0.00%,0,0.00%,0,0.00%
984,,"125,746","87,507",69.59%,"85,069",67.65%,"90,179",71.72%,"2,672",2.12%,"2,438",1.94%
985,,,- 2 -,,,,,www.pimsreports.state.pa.us,,,,
