,school number,graduate count,college bound,total college bound %,2- or 4-year college or university,2- or 4-year university %,total postsecondary bound,total postsecondary bound %,non-degree-granting postsecondary school,non-degree-granting postsecondary school %,specialized associate degree granting institution
0,3.0,157,92,58.60%,85,54.14%,96,61.15%,4,2.55%,7
1,17.0,285,200,70.18%,181,63.51%,200,70.18%,0,0.00%,19
2,6269.0,92,60,65.22%,59,64.13%,67,72.83%,7,7.61%,1
3,6271.0,228,179,78.51%,168,73.68%,180,78.95%,1,0.44%,11
4,14.0,133,76,57.14%,69,51.88%,83,62.41%,7,5.26%,7
5,21.0,119,88,73.95%,85,71.43%,89,74.79%,1,0.84%,3
6,7727.0,124,101,81.45%,96,77.42%,102,82.26%,1,0.81%,5
7,7846.0,23,19,82.61%,19,82.61%,19,82.61%,0,0.00%,0
8,7562.0,39,31,79.49%,30,76.92%,31,79.49%,0,0.00%,1
9,409.0,304,257,84.54%,252,82.89%,262,86.18%,5,1.64%,5
10,412.0,188,137,72.87%,124,65.96%,139,73.94%,2,1.06%,13
11,416.0,138,82,59.42%,73,52.90%,82,59.42%,0,0.00%,9
12,6047.0,15,0,0.00%,0,0.00%,0,0.00%,0,0.00%,0
13,6664.0,5,0,0.00%,0,0.00%,0,0.00%,0,0.00%,0
14,6811.0,7,0,0.00%,0,0.00%,0,0.00%,0,0.00%,0
15,6915.0,332,241,72.59%,234,70.48%,248,74.70%,7,2.11%,7
16,8105.0,109,99,90.83%,99,90.83%,99,90.83%,0,0.00%,0
17,8106.0,140,133,95.00%,133,95.00%,133,95.00%,0,0.00%,0
18,8107.0,79,64,81.01%,64,81.01%,64,81.01%,0,0.00%,0
19,8110.0,107,0,0.00%,0,0.00%,0,0.00%,0,0.00%,0
20,8203.0,65,41,63.08%,41,63.08%,43,66.15%,2,3.08%,0
21,8300.0,30,24,80.00%,24,80.00%,24,80.00%,0,0.00%,0
22,7772.0,45,0,0.00%,0,0.00%,0,0.00%,0,0.00%,0
23,29.0,72,50,69.44%,50,69.44%,51,70.83%,1,1.39%,0
24,5199.0,93,81,87.10%,81,87.10%,84,90.32%,3,3.23%,0
25,315.0,377,349,92.57%,349,92.57%,351,93.10%,2,0.53%,0
26,50.0,320,266,83.13%,257,80.31%,277,86.56%,11,3.44%,9
27,62.0,357,293,82.07%,293,82.07%,293,82.07%,0,0.00%,0
28,70.0,82,68,82.93%,65,79.27%,70,85.37%,2,2.44%,3
29,79.0,95,69,72.63%,66,69.47%,73,76.84%,4,4.21%,3
30,6706.0,262,224,85.50%,220,83.97%,230,87.79%,6,2.29%,4
31,8094.0,40,24,60.00%,24,60.00%,24,60.00%,0,0.00%,0
32,8087.0,44,28,63.64%,28,63.64%,28,63.64%,0,0.00%,0
33,513.0,169,148,87.57%,148,87.57%,148,87.57%,0,0.00%,0
34,8340.0,113,83,73.45%,77,68.14%,84,74.34%,1,0.88%,6
35,144.0,199,129,64.82%,119,59.80%,132,66.33%,3,1.51%,10
36,7648.0,6,0,0.00%,0,0.00%,0,0.00%,0,0.00%,0
37,156.0,363,329,90.63%,323,88.98%,334,92.01%,5,1.38%,6
38,170.0,296,231,78.04%,228,77.03%,234,79.05%,3,1.01%,3
39,5190.0,261,231,88.51%,230,88.12%,237,90.80%,6,2.30%,1
40,5153.0,190,112,58.95%,100,52.63%,120,63.16%,8,4.21%,12
41,5112.0,164,122,74.39%,112,68.29%,123,75.00%,1,0.61%,10
42,6105.0,239,143,59.83%,136,56.90%,163,68.20%,20,8.37%,7
43,5017.0,217,183,84.33%,173,79.72%,183,84.33%,0,0.00%,10
44,4951.0,289,263,91.00%,257,88.93%,263,91.00%,0,0.00%,6
45,254.0,379,355,93.67%,355,93.67%,357,94.20%,2,0.53%,0
46,8305.0,665,615,92.48%,611,91.88%,624,93.83%,9,1.35%,4
47,53.0,79,63,79.75%,56,70.89%,66,83.54%,3,3.80%,7
48,7101.0,336,277,82.44%,273,81.25%,287,85.42%,10,2.98%,4
49,309.0,322,263,81.68%,253,78.57%,266,82.61%,3,0.93%,10
50,435.0,308,261,84.74%,256,83.12%,267,86.69%,6,1.95%,5
51,448.0,143,118,82.52%,118,82.52%,122,85.31%,4,2.80%,0
52,6928.0,66,61,92.42%,60,90.91%,61,92.42%,0,0.00%,1
53,460.0,385,311,80.78%,305,79.22%,322,83.64%,11,2.86%,6
54,440.0,128,86,67.19%,84,65.63%,94,73.44%,8,6.25%,2
55,470.0,200,187,93.50%,186,93.00%,191,95.50%,4,2.00%,1
56,467.0,150,129,86.00%,129,86.00%,131,87.33%,2,1.33%,0
57,196.0,113,85,75.22%,79,69.91%,88,77.88%,3,2.65%,6
58,477.0,76,43,56.58%,43,56.58%,43,56.58%,0,0.00%,0
59,492.0,314,294,93.63%,291,92.68%,298,94.90%,4,1.27%,3
60,509.0,249,185,74.30%,174,69.88%,188,75.50%,3,1.20%,11
61,523.0,241,204,84.65%,193,80.08%,213,88.38%,9,3.73%,11
62,536.0,236,162,68.64%,152,64.41%,168,71.19%,6,2.54%,10
63,555.0,21,9,42.86%,9,42.86%,9,42.86%,0,0.00%,0
64,107.0,253,167,66.01%,162,64.03%,174,68.77%,7,2.77%,5
65,7821.0,52,22,42.31%,16,30.77%,22,42.31%,0,0.00%,6
66,8129.0,67,0,0.00%,0,0.00%,0,0.00%,0,0.00%,0
67,2320.0,91,63,69.23%,60,65.93%,64,70.33%,1,1.10%,3
68,7640.0,66,50,75.76%,48,72.73%,50,75.76%,0,0.00%,2
69,8342.0,181,125,69.06%,125,69.06%,125,69.06%,0,0.00%,0
70,594.0,132,111,84.09%,106,80.30%,111,84.09%,0,0.00%,5
71,7923.0,60,35,58.33%,34,56.67%,38,63.33%,3,5.00%,1
72,4807.0,183,51,27.87%,47,25.68%,73,39.89%,22,12.02%,4
73,7859.0,149,112,75.17%,112,75.17%,122,81.88%,10,6.71%,0
74,8086.0,76,50,65.79%,44,57.89%,50,65.79%,0,0.00%,6
75,6555.0,184,124,67.39%,109,59.24%,127,69.02%,3,1.63%,15
76,640.0,179,137,76.54%,132,73.74%,139,77.65%,2,1.12%,5
77,649.0,95,58,61.05%,57,60.00%,60,63.16%,2,2.11%,1
78,6707.0,195,162,83.08%,152,77.95%,167,85.64%,5,2.56%,10
79,8044.0,160,125,78.13%,121,75.63%,129,80.63%,4,2.50%,4
80,6563.0,104,74,71.15%,74,71.15%,75,72.12%,1,0.96%,0
81,7650.0,"1,390",785,56.47%,635,45.68%,819,58.92%,34,2.45%,150
82,675.0,196,154,78.57%,141,71.94%,156,79.59%,2,1.02%,13
83,695.0,105,76,72.38%,69,65.71%,77,73.33%,1,0.95%,7
84,700.0,104,86,82.69%,81,77.88%,86,82.69%,0,0.00%,5
85,8000.0,33,24,72.73%,21,63.64%,24,72.73%,0,0.00%,3
86,714.0,82,67,81.71%,67,81.71%,67,81.71%,0,0.00%,0
87,719.0,60,40,66.67%,36,60.00%,42,70.00%,2,3.33%,4
88,726.0,165,101,61.21%,98,59.39%,103,62.42%,2,1.21%,3
89,732.0,116,65,56.03%,52,44.83%,69,59.48%,4,3.45%,13
90,7897.0,121,65,53.72%,65,53.72%,69,57.02%,4,3.31%,0
91,747.0,85,38,44.71%,33,38.82%,44,51.76%,6,7.06%,5
92,8154.0,27,18,66.67%,18,66.67%,19,70.37%,1,3.70%,0
93,753.0,68,32,47.06%,25,36.76%,35,51.47%,3,4.41%,7
94,8155.0,127,95,74.80%,87,68.50%,99,77.95%,4,3.15%,8
95,820.0,59,45,76.27%,41,69.49%,45,76.27%,0,0.00%,4
96,6306.0,487,347,71.25%,337,69.20%,360,73.92%,13,2.67%,10
97,6308.0,150,105,70.00%,100,66.67%,106,70.67%,1,0.67%,5
98,777.0,225,165,73.33%,157,69.78%,171,76.00%,6,2.67%,8
99,4810.0,252,198,78.57%,198,78.57%,198,78.57%,0,0.00%,0
100,788.0,342,256,74.85%,254,74.27%,270,78.95%,14,4.09%,2
101,5023.0,229,159,69.43%,153,66.81%,160,69.87%,1,0.44%,6
102,802.0,296,186,62.84%,176,59.46%,187,63.18%,1,0.34%,10
103,808.0,154,111,72.08%,103,66.88%,112,72.73%,1,0.65%,8
104,816.0,105,76,72.38%,74,70.48%,76,72.38%,0,0.00%,2
105,6610.0,293,227,77.47%,215,73.38%,228,77.82%,1,0.34%,12
106,6318.0,113,88,77.88%,87,76.99%,90,79.65%,2,1.77%,1
107,8116.0,779,405,51.99%,404,51.86%,423,54.30%,18,2.31%,1
108,864.0,147,108,73.47%,104,70.75%,114,77.55%,6,4.08%,4
109,4670.0,100,55,55.00%,55,55.00%,63,63.00%,8,8.00%,0
110,873.0,217,171,78.80%,157,72.35%,171,78.80%,0,0.00%,14
111,6980.0,453,362,79.91%,356,78.59%,374,82.56%,12,2.65%,6
112,887.0,143,127,88.81%,124,86.71%,129,90.21%,2,1.40%,3
113,7720.0,20,5,25.00%,5,25.00%,5,25.00%,0,0.00%,0
114,913.0,521,323,62.00%,321,61.61%,344,66.03%,21,4.03%,2
115,7425.0,6,0,0.00%,0,0.00%,1,16.67%,1,16.67%,0
116,917.0,86,52,60.47%,52,60.47%,54,62.79%,2,2.33%,0
117,921.0,60,26,43.33%,26,43.33%,32,53.33%,6,10.00%,0
118,5207.0,264,176,66.67%,169,64.02%,191,72.35%,15,5.68%,7
119,941.0,101,55,54.46%,51,50.50%,56,55.45%,1,0.99%,4
120,949.0,127,74,58.27%,70,55.12%,79,62.20%,5,3.94%,4
121,951.0,29,12,41.38%,10,34.48%,14,48.28%,2,6.90%,2
122,958.0,169,88,52.07%,87,51.48%,93,55.03%,5,2.96%,1
123,988.0,65,35,53.85%,31,47.69%,41,63.08%,6,9.23%,4
124,964.0,52,37,71.15%,35,67.31%,37,71.15%,0,0.00%,2
125,965.0,64,42,65.63%,42,65.63%,46,71.88%,4,6.25%,0
126,5208.0,101,53,52.48%,51,50.50%,55,54.46%,2,1.98%,2
127,1000.0,103,54,52.43%,54,52.43%,58,56.31%,4,3.88%,0
128,1005.0,87,55,63.22%,55,63.22%,56,64.37%,1,1.15%,0
129,7726.0,23,11,47.83%,11,47.83%,12,52.17%,1,4.35%,0
130,5116.0,451,370,82.04%,366,81.15%,378,83.81%,8,1.77%,4
131,1014.0,75,46,61.33%,46,61.33%,53,70.67%,7,9.33%,0
132,1029.0,318,237,74.53%,221,69.50%,246,77.36%,9,2.83%,16
133,1030.0,369,236,63.96%,223,60.43%,237,64.23%,1,0.27%,13
134,1040.0,402,321,79.85%,320,79.60%,336,83.58%,15,3.73%,1
135,1043.0,476,416,87.39%,415,87.18%,416,87.39%,0,0.00%,1
136,5133.0,557,530,95.15%,530,95.15%,533,95.69%,3,0.54%,0
137,7790.0,593,538,90.73%,535,90.22%,544,91.74%,6,1.01%,3
138,5096.0,425,394,92.71%,393,92.47%,396,93.18%,2,0.47%,1
139,7749.0,540,485,89.81%,485,89.81%,490,90.74%,5,0.93%,0
140,8114.0,46,30,65.22%,29,63.04%,31,67.39%,1,2.17%,1
141,6455.0,622,541,86.98%,541,86.98%,563,90.51%,22,3.54%,0
142,1084.0,110,105,95.45%,105,95.45%,105,95.45%,0,0.00%,0
143,1094.0,121,91,75.21%,89,73.55%,94,77.69%,3,2.48%,2
144,1100.0,541,440,81.33%,436,80.59%,444,82.07%,4,0.74%,4
145,4682.0,790,667,84.43%,664,84.05%,682,86.33%,15,1.90%,3
146,1128.0,370,304,82.16%,304,82.16%,308,83.24%,4,1.08%,0
147,8344.0,499,394,78.96%,385,77.15%,412,82.57%,18,3.61%,9
148,1154.0,120,75,62.50%,70,58.33%,86,71.67%,11,9.17%,5
149,1159.0,247,211,85.43%,210,85.02%,212,85.83%,1,0.40%,1
150,1164.0,92,59,64.13%,52,56.52%,59,64.13%,0,0.00%,7
151,1172.0,148,70,47.30%,68,45.95%,70,47.30%,0,0.00%,2
152,1177.0,249,192,77.11%,191,76.71%,196,78.71%,4,1.61%,1
153,8318.0,548,472,86.13%,472,86.13%,473,86.31%,1,0.18%,0
154,5135.0,49,28,57.14%,23,46.94%,30,61.22%,2,4.08%,5
155,5212.0,115,72,62.61%,68,59.13%,73,63.48%,1,0.87%,4
156,1208.0,144,94,65.28%,89,61.81%,97,67.36%,3,2.08%,5
157,5136.0,56,29,51.79%,28,50.00%,35,62.50%,6,10.71%,1
158,1225.0,50,27,54.00%,27,54.00%,29,58.00%,2,4.00%,0
159,1191.0,145,95,65.52%,91,62.76%,100,68.97%,5,3.45%,4
160,1251.0,177,102,57.63%,92,51.98%,102,57.63%,0,0.00%,10
161,8314.0,8,3,37.50%,2,25.00%,3,37.50%,0,0.00%,1
162,6201.0,84,57,67.86%,54,64.29%,58,69.05%,1,1.19%,3
163,0.0,2,0,0.00%,0,0.00%,0,0.00%,0,0.00%,0
164,1213.0,113,88,77.88%,88,77.88%,94,83.19%,6,5.31%,0
165,1270.0,61,36,59.02%,28,45.90%,42,68.85%,6,9.84%,8
166,7941.0,117,89,76.07%,87,74.36%,91,77.78%,2,1.71%,2
167,1293.0,138,109,78.99%,103,74.64%,109,78.99%,0,0.00%,6
168,1299.0,39,22,56.41%,20,51.28%,22,56.41%,0,0.00%,2
169,4870.0,88,45,51.14%,42,47.73%,45,51.14%,0,0.00%,3
170,1307.0,119,100,84.03%,98,82.35%,103,86.55%,3,2.52%,2
171,1315.0,164,128,78.05%,127,77.44%,128,78.05%,0,0.00%,1
172,4734.0,111,90,81.08%,87,78.38%,98,88.29%,8,7.21%,3
173,8348.0,84,49,58.33%,46,54.76%,49,58.33%,0,0.00%,3
174,1327.0,57,47,82.46%,47,82.46%,47,82.46%,0,0.00%,0
175,1335.0,135,64,47.41%,55,40.74%,72,53.33%,8,5.93%,9
176,1343.0,183,123,67.21%,123,67.21%,125,68.31%,2,1.09%,0
177,6231.0,84,55,65.48%,51,60.71%,57,67.86%,2,2.38%,4
178,1364.0,541,440,81.33%,432,79.85%,441,81.52%,1,0.18%,8
179,7691.0,127,65,51.18%,65,51.18%,67,52.76%,2,1.57%,0
180,7721.0,68,55,80.88%,55,80.88%,58,85.29%,3,4.41%,0
181,7819.0,294,203,69.05%,200,68.03%,227,77.21%,24,8.16%,3
182,1367.0,419,352,84.01%,351,83.77%,369,88.07%,17,4.06%,1
183,5012.0,427,300,70.26%,282,66.04%,303,70.96%,3,0.70%,18
184,1387.0,364,306,84.07%,306,84.07%,325,89.29%,19,5.22%,0
185,7759.0,381,347,91.08%,347,91.08%,361,94.75%,14,3.67%,0
186,8174.0,189,187,98.94%,187,98.94%,187,98.94%,0,0.00%,0
187,7628.0,63,57,90.48%,57,90.48%,58,92.06%,1,1.59%,0
188,7636.0,62,57,91.94%,56,90.32%,58,93.55%,1,1.61%,1
189,1424.0,278,261,93.88%,261,93.88%,262,94.24%,1,0.36%,0
190,0.0,10,1,10.00%,1,10.00%,2,20.00%,1,10.00%,0
191,6482.0,287,225,78.40%,224,78.05%,231,80.49%,6,2.09%,1
192,1414.0,149,119,79.87%,101,67.79%,122,81.88%,3,2.01%,18
193,1406.0,375,326,86.93%,326,86.93%,327,87.20%,1,0.27%,0
194,1420.0,286,203,70.98%,198,69.23%,214,74.83%,11,3.85%,5
195,1426.0,235,203,86.38%,203,86.38%,209,88.94%,6,2.55%,0
196,1423.0,493,484,98.17%,482,97.77%,485,98.38%,1,0.20%,2
197,1443.0,306,295,96.41%,295,96.41%,301,98.37%,6,1.96%,0
198,1453.0,312,281,90.06%,281,90.06%,289,92.63%,8,2.56%,0
199,6734.0,305,277,90.82%,277,90.82%,287,94.10%,10,3.28%,0
200,7894.0,307,286,93.16%,286,93.16%,292,95.11%,6,1.95%,0
201,7824.0,113,50,44.25%,48,42.48%,61,53.98%,11,9.73%,2
202,7858.0,873,399,45.70%,375,42.96%,445,50.97%,46,5.27%,24
203,4664.0,55,30,54.55%,27,49.09%,32,58.18%,2,3.64%,3
204,1475.0,70,54,77.14%,49,70.00%,59,84.29%,5,7.14%,5
205,1480.0,58,41,70.69%,39,67.24%,43,74.14%,2,3.45%,2
206,1486.0,78,45,57.69%,44,56.41%,52,66.67%,7,8.97%,1
207,1489.0,45,27,60.00%,27,60.00%,28,62.22%,1,2.22%,0
208,1495.0,80,53,66.25%,51,63.75%,53,66.25%,0,0.00%,2
209,1501.0,48,30,62.50%,28,58.33%,34,70.83%,4,8.33%,2
210,6156.0,246,143,58.13%,130,52.85%,151,61.38%,8,3.25%,13
211,6236.0,181,96,53.04%,90,49.72%,110,60.77%,14,7.73%,6
212,1529.0,97,65,67.01%,51,52.58%,67,69.07%,2,2.06%,14
213,5219.0,52,34,65.38%,29,55.77%,38,73.08%,4,7.69%,5
214,8316.0,29,13,44.83%,10,34.48%,16,55.17%,3,10.34%,3
215,1550.0,64,40,62.50%,36,56.25%,45,70.31%,5,7.81%,4
216,1560.0,122,73,59.84%,64,52.46%,77,63.11%,4,3.28%,9
217,1566.0,89,58,65.17%,48,53.93%,58,65.17%,0,0.00%,10
218,7635.0,15,9,60.00%,9,60.00%,9,60.00%,0,0.00%,0
219,6241.0,40,20,50.00%,20,50.00%,30,75.00%,10,25.00%,0
220,7589.0,279,161,57.71%,159,56.99%,168,60.22%,7,2.51%,2
221,1595.0,57,35,61.40%,33,57.89%,35,61.40%,0,0.00%,2
222,1605.0,194,144,74.23%,142,73.20%,146,75.26%,2,1.03%,2
223,1612.0,97,83,85.57%,82,84.54%,83,85.57%,0,0.00%,1
224,1619.0,113,93,82.30%,91,80.53%,94,83.19%,1,0.88%,2
225,5178.0,135,43,31.85%,41,30.37%,47,34.81%,4,2.96%,2
226,1623.0,43,32,74.42%,30,69.77%,32,74.42%,0,0.00%,2
227,1627.0,121,95,78.51%,95,78.51%,95,78.51%,0,0.00%,0
228,7567.0,28,12,42.86%,12,42.86%,13,46.43%,1,3.57%,0
229,8224.0,152,57,37.50%,57,37.50%,70,46.05%,13,8.55%,0
230,1632.0,62,34,54.84%,31,50.00%,34,54.84%,0,0.00%,3
231,1654.0,179,100,55.87%,86,48.04%,106,59.22%,6,3.35%,14
232,1629.0,77,50,64.94%,42,54.55%,50,64.94%,0,0.00%,8
233,6136.0,78,46,58.97%,43,55.13%,52,66.67%,6,7.69%,3
234,6942.0,82,40,48.78%,40,48.78%,43,52.44%,3,3.66%,0
235,1677.0,197,111,56.35%,108,54.82%,112,56.85%,1,0.51%,3
236,1682.0,97,90,92.78%,90,92.78%,90,92.78%,0,0.00%,0
237,1694.0,319,220,68.97%,218,68.34%,220,68.97%,0,0.00%,2
238,1701.0,594,467,78.62%,464,78.11%,471,79.29%,4,0.67%,3
239,1707.0,198,144,72.73%,144,72.73%,144,72.73%,0,0.00%,0
240,5098.0,238,198,83.19%,192,80.67%,198,83.19%,0,0.00%,6
241,5221.0,244,148,60.66%,146,59.84%,150,61.48%,2,0.82%,2
242,6328.0,157,116,73.89%,112,71.34%,119,75.80%,3,1.91%,4
243,7774.0,875,199,22.74%,177,20.23%,207,23.66%,8,0.91%,22
244,1745.0,406,316,77.83%,316,77.83%,318,78.33%,2,0.49%,0
245,1746.0,323,164,50.77%,163,50.46%,165,51.08%,1,0.31%,1
246,5278.0,210,108,51.43%,99,47.14%,124,59.05%,16,7.62%,9
247,4801.0,277,247,89.17%,246,88.81%,249,89.89%,2,0.72%,1
248,6330.0,74,61,82.43%,61,82.43%,61,82.43%,0,0.00%,0
249,6333.0,152,72,47.37%,72,47.37%,74,48.68%,2,1.32%,0
250,7902.0,73,67,91.78%,67,91.78%,67,91.78%,0,0.00%,0
251,1776.0,274,197,71.90%,184,67.15%,199,72.63%,2,0.73%,13
252,7844.0,5,0,0.00%,0,0.00%,0,0.00%,0,0.00%,0
253,1790.0,154,100,64.94%,92,59.74%,102,66.23%,2,1.30%,8
254,1794.0,63,51,80.95%,49,77.78%,53,84.13%,2,3.17%,2
255,8278.0,51,32,62.75%,32,62.75%,32,62.75%,0,0.00%,0
256,1801.0,77,47,61.04%,47,61.04%,49,63.64%,2,2.60%,0
257,1806.0,217,182,83.87%,178,82.03%,183,84.33%,1,0.46%,4
258,6340.0,101,76,75.25%,68,67.33%,76,75.25%,0,0.00%,8
259,6492.0,186,0,0.00%,0,0.00%,0,0.00%,0,0.00%,0
260,8303.0,97,0,0.00%,0,0.00%,0,0.00%,0,0.00%,0
261,1849.0,202,155,76.73%,150,74.26%,167,82.67%,12,5.94%,5
262,1869.0,381,346,90.81%,344,90.29%,349,91.60%,3,0.79%,2
263,1879.0,421,394,93.59%,393,93.35%,396,94.06%,2,0.48%,1
264,1885.0,273,205,75.09%,195,71.43%,209,76.56%,4,1.47%,10
265,1902.0,310,267,86.13%,259,83.55%,270,87.10%,3,0.97%,8
266,0.0,1,0,0.00%,0,0.00%,0,0.00%,0,0.00%,0
267,1915.0,264,228,86.36%,225,85.23%,228,86.36%,0,0.00%,3
268,1921.0,296,273,92.23%,273,92.23%,274,92.57%,1,0.34%,0
269,1934.0,404,309,76.49%,307,75.99%,314,77.72%,5,1.24%,2
270,1942.0,312,280,89.74%,279,89.42%,286,91.67%,6,1.92%,1
271,6516.0,267,168,62.92%,168,62.92%,183,68.54%,15,5.62%,0
272,1950.0,280,252,90.00%,252,90.00%,258,92.14%,6,2.14%,0
273,1972.0,847,477,56.32%,466,55.02%,477,56.32%,0,0.00%,11
274,5287.0,251,223,88.84%,222,88.45%,225,89.64%,2,0.80%,1
275,8231.0,339,140,41.30%,140,41.30%,144,42.48%,4,1.18%,0
276,6218.0,40,26,65.00%,24,60.00%,28,70.00%,2,5.00%,2
277,1989.0,84,62,73.81%,61,72.62%,62,73.81%,0,0.00%,1
278,5169.0,176,111,63.07%,110,62.50%,120,68.18%,9,5.11%,1
279,7770.0,66,31,46.97%,28,42.42%,31,46.97%,0,0.00%,3
280,1998.0,159,69,43.40%,65,40.88%,81,50.94%,12,7.55%,4
281,2026.0,170,83,48.82%,83,48.82%,83,48.82%,0,0.00%,0
282,2027.0,106,64,60.38%,59,55.66%,64,60.38%,0,0.00%,5
283,7294.0,228,132,57.89%,126,55.26%,132,57.89%,0,0.00%,6
284,7515.0,167,165,98.80%,164,98.20%,165,98.80%,0,0.00%,1
285,6737.0,118,95,80.51%,95,80.51%,95,80.51%,0,0.00%,0
286,2037.0,164,115,70.12%,93,56.71%,121,73.78%,6,3.66%,22
287,2040.0,197,152,77.16%,152,77.16%,153,77.66%,1,0.51%,0
288,2043.0,133,77,57.89%,71,53.38%,84,63.16%,7,5.26%,6
289,7948.0,147,95,64.63%,95,64.63%,95,64.63%,0,0.00%,0
290,4817.0,67,42,62.69%,38,56.72%,45,67.16%,3,4.48%,4
291,8071.0,502,338,67.33%,331,65.94%,347,69.12%,9,1.79%,7
292,6145.0,103,53,51.46%,53,51.46%,55,53.40%,2,1.94%,0
293,6745.0,117,67,57.26%,59,50.43%,67,57.26%,0,0.00%,8
294,2075.0,86,38,44.19%,38,44.19%,41,47.67%,3,3.49%,0
295,6148.0,101,56,55.45%,48,47.52%,56,55.45%,0,0.00%,8
296,6001.0,265,146,55.09%,120,45.28%,149,56.23%,3,1.13%,26
297,4818.0,116,75,64.66%,64,55.17%,75,64.66%,0,0.00%,11
298,5228.0,218,141,64.68%,134,61.47%,152,69.72%,11,5.05%,7
299,2126.0,77,48,62.34%,45,58.44%,52,67.53%,4,5.19%,3
300,6600.0,193,139,72.02%,136,70.47%,149,77.20%,10,5.18%,3
301,6643.0,108,24,22.22%,20,18.52%,36,33.33%,12,11.11%,4
302,2184.0,166,99,59.64%,89,53.61%,106,63.86%,7,4.22%,10
303,6159.0,9,5,55.56%,4,44.44%,5,55.56%,0,0.00%,1
304,6161.0,19,8,42.11%,8,42.11%,8,42.11%,0,0.00%,0
305,2191.0,471,256,54.35%,253,53.72%,263,55.84%,7,1.49%,3
306,8244.0,180,81,45.00%,74,41.11%,83,46.11%,2,1.11%,7
307,2201.0,52,23,44.23%,23,44.23%,28,53.85%,5,9.62%,0
308,2206.0,242,166,68.60%,163,67.36%,169,69.83%,3,1.24%,3
309,6280.0,181,103,56.91%,103,56.91%,106,58.56%,3,1.66%,0
310,2243.0,297,207,69.70%,206,69.36%,219,73.74%,12,4.04%,1
311,6252.0,46,31,67.39%,29,63.04%,31,67.39%,0,0.00%,2
312,2246.0,31,16,51.61%,13,41.94%,16,51.61%,0,0.00%,3
313,2253.0,61,34,55.74%,31,50.82%,34,55.74%,0,0.00%,3
314,7112.0,86,61,70.93%,57,66.28%,64,74.42%,3,3.49%,4
315,5118.0,143,104,72.73%,92,64.34%,104,72.73%,0,0.00%,12
316,2280.0,67,44,65.67%,43,64.18%,45,67.16%,1,1.49%,1
317,2284.0,40,20,50.00%,17,42.50%,21,52.50%,1,2.50%,3
318,7136.0,49,23,46.94%,23,46.94%,23,46.94%,0,0.00%,0
319,2305.0,136,92,67.65%,88,64.71%,97,71.32%,5,3.68%,4
320,2308.0,62,42,67.74%,40,64.52%,50,80.65%,8,12.90%,2
321,7944.0,102,59,57.84%,56,54.90%,63,61.76%,4,3.92%,3
322,2313.0,76,37,48.68%,37,48.68%,39,51.32%,2,2.63%,0
323,7762.0,29,7,24.14%,4,13.79%,8,27.59%,1,3.45%,3
324,2353.0,65,48,73.85%,47,72.31%,53,81.54%,5,7.69%,1
325,4706.0,64,46,71.88%,44,68.75%,47,73.44%,1,1.56%,2
326,2331.0,53,40,75.47%,34,64.15%,42,79.25%,2,3.77%,6
327,2325.0,184,138,75.00%,134,72.83%,138,75.00%,0,0.00%,4
328,2339.0,93,56,60.22%,48,51.61%,60,64.52%,4,4.30%,8
329,2345.0,73,36,49.32%,31,42.47%,40,54.79%,4,5.48%,5
330,2350.0,63,37,58.73%,35,55.56%,40,63.49%,3,4.76%,2
331,2358.0,77,53,68.83%,53,68.83%,54,70.13%,1,1.30%,0
332,2362.0,85,54,63.53%,50,58.82%,54,63.53%,0,0.00%,4
333,6162.0,108,55,50.93%,54,50.00%,57,52.78%,2,1.85%,1
334,5180.0,75,14,18.67%,10,13.33%,15,20.00%,1,1.33%,4
335,6165.0,146,102,69.86%,94,64.38%,111,76.03%,9,6.16%,8
336,2394.0,81,42,51.85%,38,46.91%,42,51.85%,0,0.00%,4
337,6255.0,127,70,55.12%,69,54.33%,70,55.12%,0,0.00%,1
338,5091.0,237,206,86.92%,203,85.65%,208,87.76%,2,0.84%,3
339,2420.0,91,72,79.12%,66,72.53%,72,79.12%,0,0.00%,6
340,8312.0,106,86,81.13%,86,81.13%,92,86.79%,6,5.66%,0
341,6404.0,100,71,71.00%,70,70.00%,74,74.00%,3,3.00%,1
342,8304.0,100,68,68.00%,68,68.00%,70,70.00%,2,2.00%,0
343,2446.0,249,186,74.70%,177,71.08%,189,75.90%,3,1.20%,9
344,2449.0,66,53,80.30%,51,77.27%,55,83.33%,2,3.03%,2
345,2496.0,107,91,85.05%,86,80.37%,92,85.98%,1,0.93%,5
346,2489.0,188,135,71.81%,120,63.83%,136,72.34%,1,0.53%,15
347,6413.0,316,235,74.37%,235,74.37%,252,79.75%,17,5.38%,0
348,6775.0,184,149,80.98%,146,79.35%,151,82.07%,2,1.09%,3
349,6290.0,259,176,67.95%,162,62.55%,177,68.34%,1,0.39%,14
350,2515.0,67,30,44.78%,25,37.31%,34,50.75%,4,5.97%,5
351,2532.0,306,221,72.22%,192,62.75%,223,72.88%,2,0.65%,29
352,2539.0,219,140,63.93%,132,60.27%,146,66.67%,6,2.74%,8
353,2554.0,238,129,54.20%,123,51.68%,132,55.46%,3,1.26%,6
354,2562.0,287,204,71.08%,191,66.55%,207,72.13%,3,1.05%,13
355,6293.0,305,198,64.92%,190,62.30%,214,70.16%,16,5.25%,8
356,7538.0,29,19,65.52%,19,65.52%,25,86.21%,6,20.69%,0
357,2578.0,521,401,76.97%,395,75.82%,415,79.65%,14,2.69%,6
358,2607.0,243,183,75.31%,165,67.90%,187,76.95%,4,1.65%,18
359,2596.0,549,384,69.95%,365,66.48%,397,72.31%,13,2.37%,19
360,7922.0,134,58,43.28%,52,38.81%,64,47.76%,6,4.48%,6
361,2618.0,158,116,73.42%,106,67.09%,118,74.68%,2,1.27%,10
362,2623.0,419,334,79.71%,325,77.57%,338,80.67%,4,0.95%,9
363,2633.0,409,271,66.26%,262,64.06%,278,67.97%,7,1.71%,9
364,2649.0,129,62,48.06%,60,46.51%,66,51.16%,4,3.10%,2
365,2658.0,246,153,62.20%,144,58.54%,163,66.26%,10,4.07%,9
366,2663.0,350,247,70.57%,237,67.71%,249,71.14%,2,0.57%,10
367,2675.0,117,83,70.94%,83,70.94%,99,84.62%,16,13.68%,0
368,2680.0,98,75,76.53%,69,70.41%,75,76.53%,0,0.00%,6
369,4940.0,148,59,39.86%,57,38.51%,80,54.05%,21,14.19%,2
370,0.0,1,0,0.00%,0,0.00%,0,0.00%,0,0.00%,0
371,2686.0,118,85,72.03%,82,69.49%,88,74.58%,3,2.54%,3
372,0.0,1,0,0.00%,0,0.00%,0,0.00%,0,0.00%,0
373,2689.0,85,75,88.24%,75,88.24%,77,90.59%,2,2.35%,0
374,2704.0,176,120,68.18%,119,67.61%,130,73.86%,10,5.68%,1
375,2708.0,100,83,83.00%,79,79.00%,85,85.00%,2,2.00%,4
376,2712.0,42,31,73.81%,28,66.67%,36,85.71%,5,11.90%,3
377,2721.0,91,63,69.23%,62,68.13%,66,72.53%,3,3.30%,1
378,2725.0,129,85,65.89%,85,65.89%,86,66.67%,1,0.78%,0
379,4800.0,358,249,69.55%,232,64.80%,258,72.07%,9,2.51%,17
380,2740.0,173,102,58.96%,102,58.96%,105,60.69%,3,1.73%,0
381,5155.0,239,125,52.30%,118,49.37%,134,56.07%,9,3.77%,7
382,2760.0,168,100,59.52%,94,55.95%,102,60.71%,2,1.19%,6
383,2766.0,250,192,76.80%,192,76.80%,192,76.80%,0,0.00%,0
384,2794.0,512,328,64.06%,324,63.28%,342,66.80%,14,2.73%,4
385,2795.0,344,237,68.90%,228,66.28%,248,72.09%,11,3.20%,9
386,2798.0,103,67,65.05%,65,63.11%,67,65.05%,0,0.00%,2
387,2809.0,609,496,81.44%,490,80.46%,497,81.61%,1,0.16%,6
388,7629.0,30,27,90.00%,26,86.67%,27,90.00%,0,0.00%,1
389,2818.0,138,93,67.39%,85,61.59%,95,68.84%,2,1.45%,8
390,2821.0,178,142,79.78%,139,78.09%,144,80.90%,2,1.12%,3
391,2829.0,761,656,86.20%,650,85.41%,669,87.91%,13,1.71%,6
392,2833.0,143,125,87.41%,125,87.41%,126,88.11%,1,0.70%,0
393,2839.0,248,145,58.47%,145,58.47%,145,58.47%,0,0.00%,0
394,2848.0,359,246,68.52%,243,67.69%,250,69.64%,4,1.11%,3
395,8125.0,51,51,100.00%,51,100.00%,51,100.00%,0,0.00%,0
396,2860.0,245,201,82.04%,200,81.63%,201,82.04%,0,0.00%,1
397,2869.0,225,175,77.78%,174,77.33%,180,80.00%,5,2.22%,1
398,5242.0,144,107,74.31%,104,72.22%,107,74.31%,0,0.00%,3
399,2891.0,144,110,76.39%,106,73.61%,112,77.78%,2,1.39%,4
400,7348.0,744,509,68.41%,498,66.94%,523,70.30%,14,1.88%,11
401,2924.0,139,106,76.26%,105,75.54%,107,76.98%,1,0.72%,1
402,2958.0,76,66,86.84%,66,86.84%,66,86.84%,0,0.00%,0
403,5058.0,241,193,80.08%,193,80.08%,195,80.91%,2,0.83%,0
404,5059.0,89,44,49.44%,44,49.44%,46,51.69%,2,2.25%,0
405,3007.0,240,159,66.25%,156,65.00%,160,66.67%,1,0.42%,3
406,3008.0,117,78,66.67%,78,66.67%,78,66.67%,0,0.00%,0
407,3009.0,128,84,65.63%,84,65.63%,88,68.75%,4,3.13%,0
408,6390.0,200,155,77.50%,150,75.00%,155,77.50%,0,0.00%,5
409,6391.0,264,195,73.86%,192,72.73%,195,73.86%,0,0.00%,3
410,6364.0,119,86,72.27%,86,72.27%,89,74.79%,3,2.52%,0
411,3034.0,177,106,59.89%,101,57.06%,109,61.58%,3,1.69%,5
412,4828.0,91,67,73.63%,67,73.63%,70,76.92%,3,3.30%,0
413,3040.0,58,36,62.07%,32,55.17%,37,63.79%,1,1.72%,4
414,3045.0,135,93,68.89%,92,68.15%,94,69.63%,1,0.74%,1
415,3048.0,65,48,73.85%,43,66.15%,48,73.85%,0,0.00%,5
416,3056.0,74,57,77.03%,57,77.03%,57,77.03%,0,0.00%,0
417,6368.0,280,132,47.14%,132,47.14%,132,47.14%,0,0.00%,0
418,4691.0,182,120,65.93%,111,60.99%,122,67.03%,2,1.10%,9
419,5245.0,78,49,62.82%,49,62.82%,52,66.67%,3,3.85%,0
420,3107.0,48,30,62.50%,30,62.50%,33,68.75%,3,6.25%,0
421,3111.0,58,32,55.17%,32,55.17%,34,58.62%,2,3.45%,0
422,3117.0,64,36,56.25%,34,53.13%,42,65.63%,6,9.38%,2
423,6122.0,47,31,65.96%,28,59.57%,31,65.96%,0,0.00%,3
424,5248.0,47,30,63.83%,30,63.83%,40,85.11%,10,21.28%,0
425,3137.0,99,63,63.64%,61,61.62%,67,67.68%,4,4.04%,2
426,7506.0,43,18,41.86%,11,25.58%,19,44.19%,1,2.33%,7
427,3145.0,145,105,72.41%,104,71.72%,107,73.79%,2,1.38%,1
428,6125.0,39,20,51.28%,15,38.46%,20,51.28%,0,0.00%,5
429,3150.0,154,128,83.12%,116,75.32%,128,83.12%,0,0.00%,12
430,6126.0,39,23,58.97%,23,58.97%,24,61.54%,1,2.56%,0
431,3155.0,88,47,53.41%,47,53.41%,59,67.05%,12,13.64%,0
432,3158.0,66,40,60.61%,38,57.58%,42,63.64%,2,3.03%,2
433,3165.0,92,75,81.52%,63,68.48%,77,83.70%,2,2.17%,12
434,8093.0,112,78,69.64%,72,64.29%,79,70.54%,1,0.89%,6
435,3124.0,106,67,63.21%,67,63.21%,67,63.21%,0,0.00%,0
436,6129.0,88,72,81.82%,66,75.00%,74,84.09%,2,2.27%,6
437,8187.0,367,190,51.77%,167,45.50%,196,53.41%,6,1.63%,23
438,7866.0,12,10,83.33%,10,83.33%,10,83.33%,0,0.00%,0
439,6935.0,317,234,73.82%,230,72.56%,246,77.60%,12,3.79%,4
440,7641.0,285,194,68.07%,190,66.67%,205,71.93%,11,3.86%,4
441,3210.0,419,318,75.89%,317,75.66%,325,77.57%,7,1.67%,1
442,3216.0,356,246,69.10%,246,69.10%,249,69.94%,3,0.84%,0
443,7738.0,441,302,68.48%,297,67.35%,311,70.52%,9,2.04%,5
444,3224.0,441,224,50.79%,224,50.79%,224,50.79%,0,0.00%,0
445,7687.0,182,113,62.09%,105,57.69%,121,66.48%,8,4.40%,8
446,3241.0,580,508,87.59%,508,87.59%,515,88.79%,7,1.21%,0
447,3260.0,314,275,87.58%,269,85.67%,281,89.49%,6,1.91%,6
448,3333.0,358,320,89.39%,317,88.55%,328,91.62%,8,2.23%,3
449,3272.0,389,360,92.54%,360,92.54%,365,93.83%,5,1.29%,0
450,8049.0,50,43,86.00%,43,86.00%,43,86.00%,0,0.00%,0
451,3295.0,363,349,96.14%,349,96.14%,351,96.69%,2,0.55%,0
452,3296.0,295,284,96.27%,283,95.93%,284,96.27%,0,0.00%,1
453,4960.0,181,174,96.13%,174,96.13%,174,96.13%,0,0.00%,0
454,3305.0,392,341,86.99%,341,86.99%,343,87.50%,2,0.51%,0
455,6729.0,332,281,84.64%,266,80.12%,281,84.64%,0,0.00%,15
456,6998.0,51,35,68.63%,31,60.78%,35,68.63%,0,0.00%,4
457,5345.0,948,831,87.66%,829,87.45%,842,88.82%,11,1.16%,2
458,3328.0,437,377,86.27%,370,84.67%,385,88.10%,8,1.83%,7
459,3338.0,246,184,74.80%,181,73.58%,186,75.61%,2,0.81%,3
460,3348.0,153,82,53.59%,82,53.59%,86,56.21%,4,2.61%,0
461,3354.0,498,411,82.53%,408,81.93%,415,83.33%,4,0.80%,3
462,3376.0,146,130,89.04%,130,89.04%,132,90.41%,2,1.37%,0
463,3367.0,538,472,87.73%,472,87.73%,477,88.66%,5,0.93%,0
464,5078.0,376,357,94.95%,357,94.95%,359,95.48%,2,0.53%,0
465,3395.0,259,235,90.73%,226,87.26%,235,90.73%,0,0.00%,9
466,3401.0,230,181,78.70%,181,78.70%,187,81.30%,6,2.61%,0
467,5081.0,214,148,69.16%,147,68.69%,153,71.50%,5,2.34%,1
468,3247.0,347,317,91.35%,316,91.07%,319,91.93%,2,0.58%,1
469,3425.0,139,109,78.42%,100,71.94%,109,78.42%,0,0.00%,9
470,7681.0,57,55,96.49%,55,96.49%,55,96.49%,0,0.00%,0
471,3434.0,236,173,73.31%,172,72.88%,173,73.31%,0,0.00%,1
472,3465.0,594,463,77.95%,452,76.09%,464,78.11%,1,0.17%,11
473,4957.0,455,352,77.36%,348,76.48%,352,77.36%,0,0.00%,4
474,7634.0,112,98,87.50%,98,87.50%,100,89.29%,2,1.79%,0
475,3482.0,635,516,81.26%,513,80.79%,524,82.52%,8,1.26%,3
476,3495.0,368,324,88.04%,323,87.77%,329,89.40%,5,1.36%,1
477,3505.0,386,319,82.64%,317,82.12%,319,82.64%,0,0.00%,2
478,6439.0,102,75,73.53%,75,73.53%,79,77.45%,4,3.92%,0
479,5352.0,169,137,81.07%,137,81.07%,139,82.25%,2,1.18%,0
480,3522.0,157,125,79.62%,122,77.71%,126,80.25%,1,0.64%,3
481,3532.0,83,44,53.01%,43,51.81%,45,54.22%,1,1.20%,1
482,3541.0,157,79,50.32%,71,45.22%,80,50.96%,1,0.64%,8
483,6936.0,99,55,55.56%,53,53.54%,59,59.60%,4,4.04%,2
484,7893.0,149,113,75.84%,94,63.09%,115,77.18%,2,1.34%,19
485,3569.0,177,107,60.45%,106,59.89%,107,60.45%,0,0.00%,1
486,5103.0,112,74,66.07%,71,63.39%,76,67.86%,2,1.79%,3
487,6341.0,66,45,68.18%,45,68.18%,45,68.18%,0,0.00%,0
488,7930.0,58,30,51.72%,30,51.72%,33,56.90%,3,5.17%,0
489,3589.0,126,83,65.87%,83,65.87%,84,66.67%,1,0.79%,0
490,3596.0,175,110,62.86%,110,62.86%,114,65.14%,4,2.29%,0
491,8083.0,40,40,100.00%,40,100.00%,40,100.00%,0,0.00%,0
492,7678.0,70,64,91.43%,64,91.43%,68,97.14%,4,5.71%,0
493,7737.0,138,112,81.16%,112,81.16%,117,84.78%,5,3.62%,0
494,7777.0,73,43,58.90%,43,58.90%,49,67.12%,6,8.22%,0
495,7909.0,112,101,90.18%,101,90.18%,102,91.07%,1,0.89%,0
496,7910.0,104,97,93.27%,90,86.54%,97,93.27%,0,0.00%,7
497,8216.0,12,8,66.67%,8,66.67%,10,83.33%,2,16.67%,0
498,7510.0,127,92,72.44%,92,72.44%,97,76.38%,5,3.94%,0
499,7513.0,150,26,17.33%,26,17.33%,26,17.33%,0,0.00%,0
500,7540.0,142,100,70.42%,98,69.01%,101,71.13%,1,0.70%,2
501,7542.0,133,0,0.00%,0,0.00%,110,82.71%,110,82.71%,0
502,7546.0,49,43,87.76%,43,87.76%,43,87.76%,0,0.00%,0
503,7574.0,100,87,87.00%,87,87.00%,90,90.00%,3,3.00%,0
504,7578.0,134,113,84.33%,108,80.60%,113,84.33%,0,0.00%,5
505,7582.0,77,74,96.10%,74,96.10%,75,97.40%,1,1.30%,0
506,7586.0,67,64,95.52%,64,95.52%,64,95.52%,0,0.00%,0
507,7587.0,113,88,77.88%,86,76.11%,89,78.76%,1,0.88%,2
508,7588.0,79,67,84.81%,67,84.81%,69,87.34%,2,2.53%,0
509,7649.0,151,139,92.05%,136,90.07%,146,96.69%,7,4.64%,3
510,7665.0,172,109,63.37%,89,51.74%,109,63.37%,0,0.00%,20
511,7666.0,274,250,91.24%,243,88.69%,251,91.61%,1,0.36%,7
512,8205.0,363,250,68.87%,219,60.33%,259,71.35%,9,2.48%,31
513,7671.0,156,156,100.00%,156,100.00%,156,100.00%,0,0.00%,0
514,7672.0,119,96,80.67%,96,80.67%,104,87.39%,8,6.72%,0
515,8207.0,227,123,54.19%,123,54.19%,149,65.64%,26,11.45%,0
516,8217.0,11,0,0.00%,0,0.00%,0,0.00%,0,0.00%,0
517,8358.0,86,73,84.88%,73,84.88%,73,84.88%,0,0.00%,0
518,0.0,49,0,0.00%,0,0.00%,0,0.00%,0,0.00%,0
519,3728.0,12,0,0.00%,0,0.00%,0,0.00%,0,0.00%,0
520,3808.0,106,0,0.00%,0,0.00%,0,0.00%,0,0.00%,0
521,3816.0,207,0,0.00%,0,0.00%,0,0.00%,0,0.00%,0
522,3818.0,140,0,0.00%,0,0.00%,0,0.00%,0,0.00%,0
523,3841.0,82,0,0.00%,0,0.00%,0,0.00%,0,0.00%,0
524,3842.0,89,0,0.00%,0,0.00%,0,0.00%,0,0.00%,0
525,3843.0,309,0,0.00%,0,0.00%,0,0.00%,0,0.00%,0
526,3844.0,113,0,0.00%,0,0.00%,0,0.00%,0,0.00%,0
527,3845.0,254,0,0.00%,0,0.00%,0,0.00%,0,0.00%,0
528,3847.0,150,0,0.00%,0,0.00%,0,0.00%,0,0.00%,0
529,3848.0,481,0,0.00%,0,0.00%,0,0.00%,0,0.00%,0
530,3849.0,233,0,0.00%,0,0.00%,0,0.00%,0,0.00%,0
531,3850.0,240,0,0.00%,0,0.00%,0,0.00%,0,0.00%,0
532,3851.0,126,0,0.00%,0,0.00%,0,0.00%,0,0.00%,0
533,3855.0,575,0,0.00%,0,0.00%,0,0.00%,0,0.00%,0
534,3857.0,135,0,0.00%,0,0.00%,0,0.00%,0,0.00%,0
535,3859.0,134,0,0.00%,0,0.00%,0,0.00%,0,0.00%,0
536,3860.0,90,0,0.00%,0,0.00%,0,0.00%,0,0.00%,0
537,3861.0,126,0,0.00%,0,0.00%,0,0.00%,0,0.00%,0
538,6527.0,304,0,0.00%,0,0.00%,0,0.00%,0,0.00%,0
539,6548.0,45,0,0.00%,0,0.00%,0,0.00%,0,0.00%,0
540,6675.0,208,0,0.00%,0,0.00%,0,0.00%,0,0.00%,0
541,6822.0,172,0,0.00%,0,0.00%,0,0.00%,0,0.00%,0
542,6996.0,166,0,0.00%,0,0.00%,0,0.00%,0,0.00%,0
543,7023.0,173,0,0.00%,0,0.00%,0,0.00%,0,0.00%,0
544,7070.0,95,0,0.00%,0,0.00%,0,0.00%,0,0.00%,0
545,7072.0,135,0,0.00%,0,0.00%,0,0.00%,0,0.00%,0
546,7245.0,97,0,0.00%,0,0.00%,0,0.00%,0,0.00%,0
547,7255.0,55,0,0.00%,0,0.00%,0,0.00%,0,0.00%,0
548,7664.0,58,0,0.00%,0,0.00%,0,0.00%,0,0.00%,0
549,7780.0,71,0,0.00%,0,0.00%,0,0.00%,0,0.00%,0
550,7782.0,125,0,0.00%,0,0.00%,0,0.00%,0,0.00%,0
551,7808.0,81,0,0.00%,0,0.00%,0,0.00%,0,0.00%,0
552,7811.0,79,0,0.00%,0,0.00%,0,0.00%,0,0.00%,0
553,7813.0,121,0,0.00%,0,0.00%,0,0.00%,0,0.00%,0
554,7815.0,66,0,0.00%,0,0.00%,0,0.00%,0,0.00%,0
555,7850.0,59,0,0.00%,0,0.00%,0,0.00%,0,0.00%,0
556,7851.0,63,0,0.00%,0,0.00%,0,0.00%,0,0.00%,0
557,7852.0,107,0,0.00%,0,0.00%,0,0.00%,0,0.00%,0
558,7855.0,93,0,0.00%,0,0.00%,0,0.00%,0,0.00%,0
559,7903.0,94,0,0.00%,0,0.00%,0,0.00%,0,0.00%,0
560,7904.0,174,0,0.00%,0,0.00%,0,0.00%,0,0.00%,0
561,7905.0,83,0,0.00%,0,0.00%,0,0.00%,0,0.00%,0
562,7906.0,118,0,0.00%,0,0.00%,0,0.00%,0,0.00%,0
563,8039.0,148,0,0.00%,0,0.00%,0,0.00%,0,0.00%,0
564,8143.0,59,0,0.00%,0,0.00%,0,0.00%,0,0.00%,0
565,8293.0,56,0,0.00%,0,0.00%,0,0.00%,0,0.00%,0
566,8298.0,36,0,0.00%,0,0.00%,0,0.00%,0,0.00%,0
567,8195.0,136,0,0.00%,0,0.00%,0,0.00%,0,0.00%,0
568,7961.0,96,81,84.38%,78,81.25%,84,87.50%,3,3.13%,3
569,8127.0,52,51,98.08%,50,96.15%,51,98.08%,0,0.00%,1
570,8148.0,24,0,0.00%,0,0.00%,0,0.00%,0,0.00%,0
571,7981.0,102,88,86.27%,88,86.27%,89,87.25%,1,0.98%,0
572,8126.0,68,57,83.82%,53,77.94%,57,83.82%,0,0.00%,4
573,4310.0,306,203,66.34%,199,65.03%,211,68.95%,8,2.61%,4
574,5261.0,366,281,76.78%,281,76.78%,298,81.42%,17,4.64%,0
575,6222.0,13,5,38.46%,3,23.08%,6,46.15%,1,7.69%,2
576,3869.0,54,30,55.56%,28,51.85%,30,55.56%,0,0.00%,2
577,6223.0,19,11,57.89%,10,52.63%,11,57.89%,0,0.00%,1
578,3875.0,47,14,29.79%,14,29.79%,16,34.04%,2,4.26%,0
579,3877.0,37,18,48.65%,18,48.65%,19,51.35%,1,2.70%,0
580,3891.0,195,146,74.87%,133,68.21%,149,76.41%,3,1.54%,13
581,7012.0,71,47,66.20%,47,66.20%,47,66.20%,0,0.00%,0
582,0.0,3,0,0.00%,0,0.00%,0,0.00%,0,0.00%,0
583,6583.0,80,57,71.25%,47,58.75%,59,73.75%,2,2.50%,10
584,8161.0,13,4,30.77%,4,30.77%,4,30.77%,0,0.00%,0
585,3883.0,140,101,72.14%,98,70.00%,102,72.86%,1,0.71%,3
586,3910.0,99,62,62.63%,61,61.62%,63,63.64%,1,1.01%,1
587,3924.0,220,145,65.91%,124,56.36%,146,66.36%,1,0.45%,21
588,3930.0,1,0,0.00%,0,0.00%,0,0.00%,0,0.00%,0
589,3940.0,62,42,67.74%,42,67.74%,47,75.81%,5,8.06%,0
590,5264.0,108,66,61.11%,63,58.33%,73,67.59%,7,6.48%,3
591,5070.0,175,139,79.43%,130,74.29%,141,80.57%,2,1.14%,9
592,3957.0,69,55,79.71%,51,73.91%,59,85.51%,4,5.80%,4
593,3914.0,55,42,76.36%,38,69.09%,43,78.18%,1,1.82%,4
594,3962.0,123,50,40.65%,50,40.65%,50,40.65%,0,0.00%,0
595,3969.0,183,132,72.13%,126,68.85%,134,73.22%,2,1.09%,6
596,6207.0,68,45,66.18%,40,58.82%,46,67.65%,1,1.47%,5
597,3978.0,75,43,57.33%,43,57.33%,45,60.00%,2,2.67%,0
598,3994.0,68,43,63.24%,40,58.82%,47,69.12%,4,5.88%,3
599,3988.0,93,50,53.76%,46,49.46%,56,60.22%,6,6.45%,4
600,6210.0,52,36,69.23%,32,61.54%,37,71.15%,1,1.92%,4
601,4002.0,25,14,56.00%,13,52.00%,15,60.00%,1,4.00%,1
602,4006.0,42,26,61.90%,22,52.38%,26,61.90%,0,0.00%,4
603,6800.0,27,21,77.78%,20,74.07%,21,77.78%,0,0.00%,1
604,8274.0,180,119,66.11%,119,66.11%,119,66.11%,0,0.00%,0
605,6216.0,30,17,56.67%,16,53.33%,18,60.00%,1,3.33%,1
606,4026.0,70,44,62.86%,43,61.43%,45,64.29%,1,1.43%,1
607,4030.0,36,19,52.78%,18,50.00%,21,58.33%,2,5.56%,1
608,4034.0,75,43,57.33%,38,50.67%,44,58.67%,1,1.33%,5
609,6418.0,78,46,58.97%,43,55.13%,47,60.26%,1,1.28%,3
610,6419.0,55,33,60.00%,30,54.55%,34,61.82%,1,1.82%,3
611,4044.0,120,83,69.17%,79,65.83%,84,70.00%,1,0.83%,4
612,4049.0,89,46,51.69%,46,51.69%,55,61.80%,9,10.11%,0
613,4054.0,48,33,68.75%,30,62.50%,35,72.92%,2,4.17%,3
614,4058.0,52,22,42.31%,21,40.38%,24,46.15%,2,3.85%,1
615,6373.0,71,39,54.93%,36,50.70%,40,56.34%,1,1.41%,3
616,4064.0,38,16,42.11%,12,31.58%,21,55.26%,5,13.16%,4
617,4068.0,68,38,55.88%,38,55.88%,41,60.29%,3,4.41%,0
618,4080.0,105,70,66.67%,63,60.00%,71,67.62%,1,0.95%,7
619,4085.0,134,116,86.57%,116,86.57%,118,88.06%,2,1.49%,0
620,4091.0,129,80,62.02%,80,62.02%,83,64.34%,3,2.33%,0
621,4098.0,80,35,43.75%,35,43.75%,44,55.00%,9,11.25%,0
622,4106.0,138,77,55.80%,73,52.90%,86,62.32%,9,6.52%,4
623,4931.0,147,91,61.90%,74,50.34%,104,70.75%,13,8.84%,17
624,1668.0,109,55,50.46%,54,49.54%,68,62.39%,13,11.93%,1
625,4126.0,53,36,67.92%,24,45.28%,36,67.92%,0,0.00%,12
626,7833.0,14,9,64.29%,9,64.29%,9,64.29%,0,0.00%,0
627,4135.0,58,35,60.34%,35,60.34%,37,63.79%,2,3.45%,0
628,4143.0,74,47,63.51%,41,55.41%,48,64.86%,1,1.35%,6
629,4146.0,40,27,67.50%,25,62.50%,27,67.50%,0,0.00%,2
630,4149.0,169,98,57.99%,90,53.25%,104,61.54%,6,3.55%,8
631,4165.0,42,22,52.38%,22,52.38%,31,73.81%,9,21.43%,0
632,4188.0,95,76,80.00%,60,63.16%,79,83.16%,3,3.16%,16
633,4181.0,89,62,69.66%,58,65.17%,63,70.79%,1,1.12%,4
634,4195.0,89,66,74.16%,66,74.16%,66,74.16%,0,0.00%,0
635,4203.0,54,35,64.81%,35,64.81%,36,66.67%,1,1.85%,0
636,4217.0,344,289,84.01%,271,78.78%,291,84.59%,2,0.58%,18
637,4715.0,103,82,79.61%,74,71.84%,82,79.61%,0,0.00%,8
638,4235.0,72,55,76.39%,54,75.00%,57,79.17%,2,2.78%,1
639,4242.0,81,52,64.20%,49,60.49%,53,65.43%,1,1.23%,3
640,4249.0,146,101,69.18%,85,58.22%,101,69.18%,0,0.00%,16
641,5083.0,364,343,94.23%,343,94.23%,346,95.05%,3,0.82%,0
642,7019.0,226,165,73.01%,158,69.91%,167,73.89%,2,0.88%,7
643,6012.0,245,154,62.86%,143,58.37%,161,65.71%,7,2.86%,11
644,4286.0,94,53,56.38%,50,53.19%,58,61.70%,5,5.32%,3
645,4295.0,171,113,66.08%,113,66.08%,119,69.59%,6,3.51%,0
646,6704.0,143,103,72.03%,94,65.73%,111,77.62%,8,5.59%,9
647,4930.0,209,144,68.90%,139,66.51%,155,74.16%,11,5.26%,5
648,4340.0,134,110,82.09%,102,76.12%,112,83.58%,2,1.49%,8
649,4352.0,184,134,72.83%,117,63.59%,135,73.37%,1,0.54%,17
650,4360.0,291,256,87.97%,251,86.25%,257,88.32%,1,0.34%,5
651,7550.0,47,19,40.43%,19,40.43%,23,48.94%,4,8.51%,0
652,4845.0,295,231,78.31%,223,75.59%,235,79.66%,4,1.36%,8
653,4373.0,182,146,80.22%,142,78.02%,146,80.22%,0,0.00%,4
654,4404.0,452,363,80.31%,357,78.98%,368,81.42%,5,1.11%,6
655,4412.0,46,33,71.74%,32,69.57%,33,71.74%,0,0.00%,1
656,4431.0,300,241,80.33%,217,72.33%,246,82.00%,5,1.67%,24
657,4442.0,130,90,69.23%,85,65.38%,97,74.62%,7,5.38%,5
658,6181.0,46,32,69.57%,30,65.22%,32,69.57%,0,0.00%,2
659,4458.0,144,114,79.17%,106,73.61%,119,82.64%,5,3.47%,8
660,8323.0,96,76,79.17%,72,75.00%,79,82.29%,3,3.13%,4
661,4717.0,374,300,80.21%,292,78.07%,305,81.55%,5,1.34%,8
662,6648.0,313,258,82.43%,255,81.47%,264,84.35%,6,1.92%,3
663,6191.0,139,92,66.19%,92,66.19%,104,74.82%,12,8.63%,0
664,4735.0,177,121,68.36%,121,68.36%,121,68.36%,0,0.00%,0
665,5271.0,194,131,67.53%,118,60.82%,143,73.71%,12,6.19%,13
666,4528.0,60,31,51.67%,30,50.00%,35,58.33%,4,6.67%,1
667,4545.0,446,346,77.58%,328,73.54%,350,78.48%,4,0.90%,18
668,4553.0,402,316,78.61%,309,76.87%,325,80.85%,9,2.24%,7
669,4558.0,183,115,62.84%,107,58.47%,123,67.21%,8,4.37%,8
670,4564.0,172,116,67.44%,110,63.95%,124,72.09%,8,4.65%,6
671,4571.0,102,58,56.86%,53,51.96%,60,58.82%,2,1.96%,5
672,7624.0,54,0,0.00%,0,0.00%,0,0.00%,0,0.00%,0
673,4577.0,217,149,68.66%,140,64.52%,155,71.43%,6,2.76%,9
674,4598.0,396,257,64.90%,232,58.59%,283,71.46%,26,6.57%,25
675,4602.0,173,120,69.36%,117,67.63%,123,71.10%,3,1.73%,3
676,4608.0,284,190,66.90%,187,65.85%,209,73.59%,19,6.69%,3
677,4614.0,237,178,75.11%,174,73.42%,191,80.59%,13,5.49%,4
678,4623.0,264,153,57.95%,139,52.65%,162,61.36%,9,3.41%,14
679,6705.0,227,166,73.13%,157,69.16%,175,77.09%,9,3.96%,9
680,4647.0,182,105,57.69%,97,53.30%,108,59.34%,3,1.65%,8
681,5168.0,351,147,41.88%,124,35.33%,148,42.17%,1,0.28%,23
682,4658.0,202,167,82.67%,165,81.68%,171,84.65%,4,1.98%,2
683,1732.0,294,223,75.85%,223,75.85%,233,79.25%,10,3.40%,0
684,4704.0,286,203,70.98%,194,67.83%,213,74.48%,10,3.50%,9
685,6345.0,236,181,76.69%,170,72.03%,182,77.12%,1,0.42%,11
686,8041.0,48,20,41.67%,18,37.50%,20,41.67%,0,0.00%,2
687,,"125,051","83,542",66.81%,"80,862",64.66%,"86,091",68.84%,"2,549",2.04%,"2,680"
688,,,- 2 -,,,,,www.pimsreports.state.pa.us,,,
