,school number,graduate count,college bound,total college bound %,2- or 4-year college or university,total postsecondary bound,total postsecondary bound %,non-degree-granting postsecondary school,non-degree-granting postsecondary school %,specialized associate degree granting institution
0,7691.0,83,56,67.5%,56,67,80.7%,11,13.3%,0
1,3241.0,637,567,89.0%,562,575,90.3%,8,1.3%,5
2,5091.0,297,263,88.6%,255,268,90.2%,5,1.7%,8
3,7846.0,51,11,21.6%,11,14,27.5%,3,5.9%,0
4,7824.0,67,23,34.3%,21,23,34.3%,0,0.0%,2
5,7858.0,144,35,24.3%,35,38,26.4%,3,2.1%,0
6,6001.0,304,160,52.6%,132,171,56.3%,11,3.6%,28
7,6554.0,72,43,59.7%,37,45,62.5%,2,2.8%,6
8,29.0,106,91,85.8%,85,92,86.8%,1,0.9%,6
9,4664.0,63,37,58.7%,37,42,66.7%,5,7.9%,0
10,2795.0,383,243,63.4%,233,245,64.0%,2,0.5%,10
11,2794.0,685,369,53.9%,362,380,55.5%,11,1.6%,7
12,913.0,512,349,68.2%,309,370,72.3%,21,4.1%,40
13,7425.0,7,1,14.3%,1,1,14.3%,0,0.0%,0
14,6555.0,188,121,64.4%,105,125,66.5%,4,2.1%,16
15,2725.0,113,89,78.8%,86,91,80.5%,2,1.8%,3
16,820.0,77,44,57.1%,43,49,63.6%,5,6.5%,1
17,2320.0,80,63,78.8%,56,64,80.0%,1,1.3%,7
18,582.0,54,33,61.1%,28,35,64.8%,2,3.7%,5
19,6575.0,88,65,73.9%,64,69,78.4%,4,4.5%,1
20,596.0,136,99,72.8%,92,103,75.7%,4,2.9%,7
21,7640.0,77,56,72.7%,51,57,74.0%,1,1.3%,5
22,958.0,173,117,67.6%,117,123,71.1%,6,3.5%,0
23,6222.0,22,11,50.0%,11,12,54.5%,1,4.5%,0
24,4165.0,41,24,58.5%,24,29,70.7%,5,12.2%,0
25,7721.0,42,29,69.0%,29,29,69.0%,0,0.0%,0
26,1367.0,383,315,82.2%,314,332,86.7%,17,4.4%,1
27,5199.0,65,57,87.7%,54,57,87.7%,0,0.0%,3
28,1335.0,169,100,59.2%,86,103,60.9%,3,1.8%,14
29,50.0,354,309,87.3%,277,317,89.5%,8,2.3%,32
30,3434.0,257,200,77.8%,196,201,78.2%,1,0.4%,4
31,7847.0,14,11,78.6%,9,12,85.7%,1,7.1%,2
32,640.0,169,143,84.6%,133,143,84.6%,0,0.0%,10
33,726.0,153,89,58.2%,87,94,61.4%,5,3.3%,2
34,742.0,27,17,63.0%,16,17,63.0%,0,0.0%,1
35,4930.0,263,212,80.6%,192,212,80.6%,0,0.0%,20
36,1343.0,246,185,75.2%,159,186,75.6%,1,0.4%,26
37,917.0,100,63,63.0%,63,69,69.0%,6,6.0%,0
38,5116.0,479,393,82.0%,378,410,85.6%,17,3.5%,15
39,1595.0,70,55,78.6%,55,56,80.0%,1,1.4%,0
40,4188.0,90,76,84.4%,65,77,85.6%,1,1.1%,11
41,6207.0,63,41,65.1%,41,41,65.1%,0,0.0%,0
42,3.0,156,114,73.1%,94,119,76.3%,5,3.2%,20
43,1605.0,212,169,79.7%,162,172,81.1%,3,1.4%,7
44,62.0,371,353,95.1%,341,357,96.2%,4,1.1%,12
45,4957.0,504,445,88.3%,435,457,90.7%,12,2.4%,10
46,3465.0,638,539,84.5%,529,544,85.3%,5,0.8%,10
47,4181.0,96,71,74.0%,59,74,77.1%,3,3.1%,12
48,649.0,128,96,75.0%,80,97,75.8%,1,0.8%,16
49,1677.0,249,147,59.0%,138,166,66.7%,19,7.6%,9
50,6707.0,226,177,78.3%,177,196,86.7%,19,8.4%,0
51,5135.0,68,42,61.8%,42,46,67.6%,4,5.9%,0
52,4706.0,88,72,81.8%,64,73,83.0%,1,1.1%,8
53,2353.0,67,52,77.6%,43,53,79.1%,1,1.5%,9
54,1612.0,108,85,78.7%,82,88,81.5%,3,2.8%,3
55,3891.0,224,177,79.0%,156,178,79.5%,1,0.4%,21
56,4034.0,96,71,74.0%,70,75,78.1%,4,4.2%,1
57,6306.0,531,381,71.8%,348,381,71.8%,0,0.0%,33
58,4691.0,243,183,75.3%,171,185,76.1%,2,0.8%,12
59,6308.0,165,119,72.1%,110,120,72.7%,1,0.6%,9
60,70.0,116,94,81.0%,83,94,81.0%,0,0.0%,11
61,1014.0,89,55,61.8%,55,65,73.0%,10,11.2%,0
62,1029.0,422,282,66.8%,255,301,71.3%,19,4.5%,27
63,2362.0,80,57,71.3%,49,60,75.0%,3,3.8%,8
64,6162.0,136,72,52.9%,68,86,63.2%,14,10.3%,4
65,4818.0,128,69,53.9%,59,69,53.9%,0,0.0%,10
66,1030.0,343,187,54.5%,177,194,56.6%,7,2.0%,10
67,4195.0,114,80,70.2%,80,86,75.4%,6,5.3%,0
68,4340.0,142,115,81.0%,106,117,82.4%,2,1.4%,9
69,1147.0,588,472,80.3%,453,489,83.2%,17,2.9%,19
70,4203.0,68,57,83.8%,51,60,88.2%,3,4.4%,6
71,5212.0,119,84,70.6%,76,88,73.9%,4,3.4%,8
72,1299.0,63,49,77.8%,44,50,79.4%,1,1.6%,5
73,1682.0,109,100,91.7%,98,100,91.7%,0,0.0%,2
74,4217.0,306,249,81.4%,240,250,81.7%,1,0.3%,9
75,988.0,91,67,73.6%,65,69,75.8%,2,2.2%,2
76,4870.0,76,27,35.5%,22,28,36.8%,1,1.3%,5
77,2420.0,95,74,77.9%,63,74,77.9%,0,0.0%,11
78,7577.0,50,18,36.0%,17,25,50.0%,7,14.0%,1
79,1694.0,322,226,70.2%,207,226,70.2%,0,0.0%,19
80,79.0,112,93,83.0%,79,93,83.0%,0,0.0%,14
81,7112.0,74,50,67.6%,46,50,67.6%,0,0.0%,4
82,2798.0,112,89,79.5%,87,89,79.5%,0,0.0%,2
83,1040.0,477,412,86.4%,408,427,89.5%,15,3.1%,4
84,654.0,167,154,92.2%,154,154,92.2%,0,0.0%,0
85,7293.0,171,80,46.8%,78,81,47.4%,1,0.6%,2
86,7726.0,22,16,72.7%,16,19,86.4%,3,13.6%,0
87,5133.0,507,474,93.5%,470,477,94.1%,3,0.6%,4
88,7790.0,569,531,93.3%,530,539,94.7%,8,1.4%,1
89,1043.0,453,408,90.1%,403,408,90.1%,0,0.0%,5
90,1208.0,164,128,78.0%,117,134,81.7%,6,3.7%,11
91,1619.0,157,133,84.7%,125,134,85.4%,1,0.6%,8
92,1746.0,411,296,72.0%,277,313,76.2%,17,4.1%,19
93,1745.0,451,391,86.7%,381,401,88.9%,10,2.2%,10
94,6252.0,66,42,63.6%,40,45,68.2%,3,4.5%,2
95,5118.0,154,113,73.4%,99,117,76.0%,4,2.6%,14
96,7720.0,20,9,45.0%,9,12,60.0%,3,15.0%,0
97,4545.0,386,325,84.2%,305,335,86.8%,10,2.6%,20
98,2191.0,591,311,52.6%,288,317,53.6%,6,1.0%,23
99,4715.0,125,93,74.4%,78,94,75.2%,1,0.8%,15
100,7578.0,135,126,93.3%,125,126,93.3%,0,0.0%,1
101,6706.0,262,238,90.8%,237,241,92.0%,3,1.1%,1
102,4235.0,91,68,74.7%,61,68,74.7%,0,0.0%,7
103,3260.0,403,386,95.8%,374,388,96.3%,2,0.5%,12
104,6492.0,414,152,36.7%,150,152,36.7%,0,0.0%,2
105,732.0,131,84,64.1%,72,89,67.9%,5,3.8%,12
106,1849.0,261,139,53.3%,136,171,65.5%,32,12.3%,3
107,7727.0,87,71,81.6%,70,76,87.4%,5,5.7%,1
108,7156.0,53,41,77.4%,41,41,77.4%,0,0.0%,0
109,1475.0,86,72,83.7%,72,76,88.4%,4,4.7%,0
110,1480.0,72,48,66.7%,45,49,68.1%,1,1.4%,3
111,921.0,68,43,63.2%,36,46,67.6%,3,4.4%,7
112,6236.0,226,153,67.7%,136,161,71.2%,8,3.5%,17
113,5012.0,534,351,65.7%,350,411,77.0%,60,11.2%,1
114,7989.0,17,3,17.6%,3,4,23.5%,1,5.9%,0
115,6290.0,301,163,54.2%,136,167,55.5%,4,1.3%,27
116,7628.0,18,18,100.0%,18,18,100.0%,0,0.0%,0
117,3333.0,441,394,89.3%,385,397,90.0%,3,0.7%,9
118,2515.0,109,61,56.0%,56,68,62.4%,7,6.4%,5
119,5178.0,154,63,40.9%,55,65,42.2%,2,1.3%,8
120,6122.0,51,34,66.7%,30,38,74.5%,4,7.8%,4
121,7774.0,91,41,45.1%,41,51,56.0%,10,11.0%,0
122,7510.0,114,72,63.2%,72,87,76.3%,15,13.2%,0
123,3978.0,105,69,65.7%,61,72,68.6%,3,2.9%,8
124,5136.0,62,44,71.0%,41,45,72.6%,1,1.6%,3
125,2532.0,252,204,81.0%,154,212,84.1%,8,3.2%,50
126,17.0,274,181,66.1%,156,184,67.2%,3,1.1%,25
127,1637.0,82,43,52.4%,43,50,61.0%,7,8.5%,0
128,1639.0,44,25,56.8%,25,25,56.8%,0,0.0%,0
129,1644.0,79,50,63.3%,45,51,64.6%,1,1.3%,5
130,6643.0,85,22,25.9%,11,22,25.9%,0,0.0%,11
131,5228.0,309,205,66.3%,195,221,71.5%,16,5.2%,10
132,777.0,251,205,81.7%,184,215,85.7%,10,4.0%,21
133,6946.0,55,49,89.1%,49,49,89.1%,0,0.0%,0
134,4800.0,383,293,76.5%,293,293,76.5%,0,0.0%,0
135,1998.0,186,101,54.3%,101,102,54.8%,1,0.5%,0
136,3869.0,70,49,70.0%,47,51,72.9%,2,2.9%,2
137,5096.0,555,521,93.9%,520,522,94.1%,1,0.2%,1
138,7749.0,531,445,83.8%,445,449,84.6%,4,0.8%,0
139,4098.0,107,61,57.0%,45,62,57.9%,1,0.9%,16
140,1632.0,76,40,52.6%,35,40,52.6%,0,0.0%,5
141,1654.0,219,123,56.2%,110,126,57.5%,3,1.4%,13
142,2860.0,272,234,86.0%,230,236,86.8%,2,0.7%,4
143,7624.0,47,4,8.5%,1,4,8.5%,0,0.0%,3
144,1701.0,588,468,79.6%,460,480,81.6%,12,2.0%,8
145,1529.0,107,75,70.1%,69,79,73.8%,4,3.7%,6
146,2869.0,213,190,89.2%,190,192,90.1%,2,0.9%,0
147,4553.0,380,288,75.8%,267,299,78.7%,11,2.9%,21
148,4810.0,262,196,74.8%,185,197,75.2%,1,0.4%,11
149,3425.0,202,164,81.2%,146,165,81.7%,1,0.5%,18
150,5278.0,239,107,44.8%,87,112,46.9%,5,2.1%,20
151,513.0,153,125,81.7%,125,130,85.0%,5,3.3%,0
152,7671.0,127,0,0.0%,0,0,0.0%,0,0.0%,0
153,5261.0,450,374,83.1%,369,390,86.7%,16,3.6%,5
154,4352.0,215,174,80.9%,149,176,81.9%,2,0.9%,25
155,4801.0,301,262,87.0%,262,262,87.0%,0,0.0%,0
156,2539.0,203,115,56.7%,114,126,62.1%,11,5.4%,1
157,4558.0,217,155,71.4%,143,162,74.7%,7,3.2%,12
158,7759.0,471,445,94.5%,440,446,94.7%,1,0.2%,5
159,1387.0,428,388,90.7%,386,389,90.9%,1,0.2%,2
160,7550.0,27,0,0.0%,0,1,3.7%,1,3.7%,0
161,6156.0,268,177,66.0%,162,187,69.8%,10,3.7%,15
162,2429.0,160,141,88.1%,136,141,88.1%,0,0.0%,5
163,5193.0,132,91,68.9%,83,95,72.0%,4,3.0%,8
164,6364.0,123,96,78.0%,96,96,78.0%,0,0.0%,0
165,2809.0,681,530,77.8%,527,538,79.0%,8,1.2%,3
166,1707.0,248,202,81.5%,202,204,82.3%,2,0.8%,0
167,7641.0,315,203,64.4%,203,225,71.4%,22,7.0%,0
168,6935.0,337,244,72.4%,244,269,79.8%,25,7.4%,0
169,2554.0,285,161,56.5%,153,163,57.2%,2,0.7%,8
170,2740.0,192,139,72.4%,120,140,72.9%,1,0.5%,19
171,4564.0,189,130,68.8%,116,134,70.9%,4,2.1%,14
172,3482.0,634,517,81.5%,511,531,83.8%,14,2.2%,6
173,144.0,245,185,75.5%,171,191,78.0%,6,2.4%,14
174,2562.0,313,215,68.7%,209,220,70.3%,5,1.6%,6
175,6418.0,103,64,62.1%,64,70,68.0%,6,5.8%,0
176,2675.0,131,111,84.7%,111,112,85.5%,1,0.8%,0
177,6293.0,287,178,62.0%,164,189,65.9%,11,3.8%,14
178,7842.0,15,0,0.0%,0,0,0.0%,0,0.0%,0
179,7294.0,163,75,46.0%,62,84,51.5%,9,5.5%,13
180,2026.0,187,101,54.0%,101,103,55.1%,2,1.1%,0
181,7515.0,180,168,93.3%,167,171,95.0%,3,1.7%,1
182,2027.0,183,96,52.5%,96,114,62.3%,18,9.8%,0
183,7897.0,116,75,64.7%,75,76,65.5%,1,0.9%,0
184,7866.0,12,11,91.7%,11,11,91.7%,0,0.0%,0
185,788.0,311,239,76.8%,239,263,84.6%,24,7.7%,0
186,6269.0,90,53,58.9%,48,60,66.7%,7,7.8%,5
187,6737.0,144,112,77.8%,107,113,78.5%,1,0.7%,5
188,2201.0,42,21,50.0%,19,22,52.4%,1,2.4%,2
189,5248.0,53,0,0.0%,0,0,0.0%,0,0.0%,0
190,1225.0,54,36,66.7%,34,36,66.7%,0,0.0%,2
191,5023.0,204,143,70.1%,142,152,74.5%,9,4.4%,1
192,2246.0,34,22,64.7%,21,24,70.6%,2,5.9%,1
193,6159.0,17,8,47.1%,8,10,58.8%,2,11.8%,0
194,6161.0,31,21,67.7%,21,21,67.7%,0,0.0%,0
195,6419.0,63,40,63.5%,38,41,65.1%,1,1.6%,2
196,1191.0,178,125,70.2%,118,130,73.0%,5,2.8%,7
197,4242.0,100,78,78.0%,77,78,78.0%,0,0.0%,1
198,2037.0,163,118,72.4%,118,121,74.2%,3,1.8%,0
199,156.0,412,385,93.4%,384,387,93.9%,2,0.5%,1
200,4106.0,172,109,63.4%,98,121,70.3%,12,7.0%,11
201,4360.0,291,251,86.3%,247,257,88.3%,6,2.1%,4
202,7666.0,210,176,83.8%,154,183,87.1%,7,3.3%,22
203,2126.0,92,62,67.4%,60,63,68.5%,1,1.1%,2
204,6563.0,151,105,69.5%,105,108,71.5%,3,2.0%,0
205,594.0,146,122,83.6%,107,123,84.2%,1,0.7%,15
206,7586.0,68,64,94.1%,62,66,97.1%,2,2.9%,2
207,6223.0,31,11,35.5%,10,18,58.1%,7,22.6%,1
208,1869.0,335,305,91.0%,304,311,92.8%,6,1.8%,1
209,170.0,362,322,89.0%,317,336,92.8%,14,3.9%,5
210,2040.0,183,128,69.9%,124,129,70.5%,1,0.5%,4
211,6271.0,263,182,69.2%,177,195,74.1%,13,4.9%,5
212,2043.0,161,103,64.0%,91,106,65.8%,3,1.9%,12
213,5219.0,64,43,67.2%,43,51,79.7%,8,12.5%,0
214,802.0,322,244,75.8%,244,259,80.4%,15,4.7%,0
215,1424.0,306,283,92.5%,283,290,94.8%,7,2.3%,0
216,1251.0,216,145,67.1%,144,145,67.1%,0,0.0%,1
217,4845.0,326,269,82.5%,263,273,83.7%,4,1.2%,6
218,5242.0,170,133,78.2%,133,134,78.8%,1,0.6%,0
219,2206.0,204,140,68.6%,128,146,71.6%,6,2.9%,12
220,4373.0,261,210,80.5%,196,214,82.0%,4,1.5%,14
221,3137.0,144,105,72.9%,101,108,75.0%,3,2.1%,4
222,6341.0,58,40,69.0%,35,42,72.4%,2,3.4%,5
223,3145.0,214,160,74.8%,154,167,78.0%,7,3.3%,6
224,6330.0,77,60,77.9%,53,62,80.5%,2,2.6%,7
225,808.0,167,123,73.7%,120,136,81.4%,13,7.8%,3
226,5190.0,245,227,92.7%,220,229,93.5%,2,0.8%,7
227,2891.0,146,108,74.0%,107,114,78.1%,6,4.1%,1
228,4571.0,89,56,62.9%,52,58,65.2%,2,2.2%,4
229,7948.0,156,113,72.4%,98,117,75.0%,4,2.6%,15
230,1547.0,34,20,58.8%,17,24,70.6%,4,11.8%,3
231,7899.0,117,0,0.0%,0,0,0.0%,0,0.0%,0
232,7900.0,52,0,0.0%,0,0,0.0%,0,0.0%,0
233,6333.0,237,0,0.0%,0,0,0.0%,0,0.0%,0
234,7902.0,84,74,88.1%,74,74,88.1%,0,0.0%,0
235,1761.0,13,0,0.0%,0,0,0.0%,0,0.0%,0
236,3272.0,407,354,87.0%,352,360,88.5%,6,1.5%,2
237,1879.0,422,387,91.7%,373,391,92.7%,4,0.9%,14
238,7348.0,777,531,68.3%,496,542,69.8%,11,1.4%,35
239,2578.0,564,450,79.8%,432,475,84.2%,25,4.4%,18
240,7747.0,4,4,100.0%,4,4,100.0%,0,0.0%,0
241,4404.0,476,410,86.1%,408,430,90.3%,20,4.2%,2
242,3150.0,191,140,73.3%,140,147,77.0%,7,3.7%,0
243,5153.0,174,125,71.8%,125,136,78.2%,11,6.3%,0
244,5207.0,306,228,74.5%,228,246,80.4%,18,5.9%,0
245,2331.0,88,65,73.9%,57,65,73.9%,0,0.0%,8
246,7723.0,89,41,46.1%,38,44,49.4%,3,3.4%,3
247,675.0,234,165,70.5%,151,170,72.6%,5,2.1%,14
248,2305.0,168,109,64.9%,100,113,67.3%,4,2.4%,9
249,7542.0,105,103,98.1%,99,104,99.0%,1,1.0%,4
250,2325.0,240,200,83.3%,191,208,86.7%,8,3.3%,9
251,1885.0,330,212,64.2%,206,212,64.2%,0,0.0%,6
252,4817.0,98,76,77.6%,66,78,79.6%,2,2.0%,10
253,6126.0,49,38,77.6%,30,38,77.6%,0,0.0%,8
254,4412.0,93,62,66.7%,55,64,68.8%,2,2.2%,7
255,5180.0,92,0,0.0%,0,0,0.0%,0,0.0%,0
256,2280.0,60,28,46.7%,25,29,48.3%,1,1.7%,3
257,3277.0,47,42,89.4%,41,42,89.4%,0,0.0%,1
258,3034.0,182,127,69.8%,127,134,73.6%,7,3.8%,0
259,1307.0,139,108,77.7%,108,110,79.1%,2,1.4%,0
260,6218.0,64,49,76.6%,49,49,76.6%,0,0.0%,0
261,2394.0,92,61,66.3%,59,61,66.3%,0,0.0%,2
262,6255.0,147,87,59.2%,61,87,59.2%,0,0.0%,26
263,2308.0,72,45,62.5%,39,51,70.8%,6,8.3%,6
264,5245.0,93,70,75.3%,70,71,76.3%,1,1.1%,0
265,1154.0,126,92,73.0%,81,98,77.8%,6,4.8%,11
266,6482.0,246,197,80.1%,197,203,82.5%,6,2.4%,0
267,1486.0,78,58,74.4%,49,60,76.9%,2,2.6%,9
268,6241.0,45,25,55.6%,25,26,57.8%,1,2.2%,0
269,7589.0,305,208,68.2%,205,210,68.9%,2,0.7%,3
270,7506.0,60,15,25.0%,6,17,28.3%,2,3.3%,9
271,5112.0,201,166,82.6%,149,167,83.1%,1,0.5%,17
272,4431.0,332,199,59.9%,178,202,60.8%,3,0.9%,21
273,816.0,142,112,78.9%,109,113,79.6%,1,0.7%,3
274,7538.0,12,4,33.3%,4,4,33.3%,0,0.0%,0
275,4528.0,104,76,73.1%,75,84,80.8%,8,7.7%,1
276,6404.0,154,128,83.1%,128,130,84.4%,2,1.3%,0
277,2924.0,152,124,81.6%,118,129,84.9%,5,3.3%,6
278,3155.0,99,70,70.7%,60,70,70.7%,0,0.0%,10
279,2607.0,277,212,76.5%,194,215,77.6%,3,1.1%,18
280,7394.0,31,12,38.7%,9,12,38.7%,0,0.0%,3
281,2596.0,489,347,71.0%,296,364,74.4%,17,3.5%,51
282,7922.0,92,53,57.6%,53,54,58.7%,1,1.1%,0
283,2680.0,103,90,87.4%,84,91,88.3%,1,1.0%,6
284,6600.0,225,170,75.6%,156,183,81.3%,13,5.8%,14
285,4940.0,106,55,51.9%,46,62,58.5%,7,6.6%,9
286,5155.0,194,127,65.5%,103,129,66.5%,2,1.0%,24
287,7923.0,44,34,77.3%,34,37,84.1%,3,6.8%,0
288,7681.0,9,8,88.9%,8,8,88.9%,0,0.0%,0
289,7634.0,108,98,90.7%,98,106,98.1%,8,7.4%,0
290,1315.0,169,125,74.0%,121,133,78.7%,8,4.7%,4
291,4807.0,215,121,56.3%,71,122,56.7%,1,0.5%,50
292,4085.0,128,102,79.7%,102,103,80.5%,1,0.8%,0
293,4437.0,50,25,50.0%,25,25,50.0%,0,0.0%,0
294,4442.0,105,81,77.1%,77,84,80.0%,3,2.9%,4
295,7859.0,108,82,75.9%,82,91,84.3%,9,8.3%,0
296,3532.0,90,62,68.9%,58,69,76.7%,7,7.8%,4
297,14.0,171,113,66.1%,109,116,67.8%,3,1.8%,4
298,1776.0,310,246,79.4%,233,252,81.3%,6,1.9%,13
299,3296.0,204,197,96.6%,194,201,98.5%,4,2.0%,3
300,3295.0,376,350,93.1%,350,355,94.4%,5,1.3%,0
301,4960.0,175,165,94.3%,164,169,96.6%,4,2.3%,1
302,4828.0,121,104,86.0%,104,104,86.0%,0,0.0%,0
303,7012.0,84,65,77.4%,64,71,84.5%,6,7.1%,1
304,2618.0,274,156,56.9%,143,159,58.0%,3,1.1%,13
305,2623.0,445,373,83.8%,369,386,86.7%,13,2.9%,4
306,7672.0,89,60,67.4%,60,66,74.2%,6,6.7%,0
307,2339.0,107,74,69.2%,66,80,74.8%,6,5.6%,8
308,7777.0,31,25,80.6%,23,25,80.6%,0,0.0%,2
309,1902.0,305,241,79.0%,235,254,83.3%,13,4.3%,6
310,1159.0,217,201,92.6%,194,203,93.5%,2,0.9%,7
311,7574.0,94,82,87.2%,82,88,93.6%,6,6.4%,0
312,7678.0,56,55,98.2%,55,55,98.2%,0,0.0%,0
313,7582.0,64,59,92.2%,59,64,100.0%,5,7.8%,0
314,4249.0,159,110,69.2%,93,115,72.3%,5,3.1%,17
315,6105.0,292,154,52.7%,140,157,53.8%,3,1.0%,14
316,5098.0,265,220,83.0%,213,229,86.4%,9,3.4%,7
317,3158.0,104,71,68.3%,71,73,70.2%,2,1.9%,0
318,3305.0,445,392,88.1%,390,396,89.0%,4,0.9%,2
319,3994.0,64,0,0.0%,0,0,0.0%,0,0.0%,0
320,7890.0,122,68,55.7%,63,68,55.7%,0,0.0%,5
321,1790.0,145,111,76.6%,110,113,77.9%,2,1.4%,1
322,3962.0,174,97,55.7%,91,98,56.3%,1,0.6%,6
323,7170.0,224,141,62.9%,125,158,70.5%,17,7.6%,16
324,6887.0,209,128,61.2%,98,132,63.2%,4,1.9%,30
325,4091.0,162,103,63.6%,103,108,66.7%,5,3.1%,0
326,6711.0,2,0,0.0%,0,0,0.0%,0,0.0%,0
327,2063.0,550,474,86.2%,449,487,88.5%,13,2.4%,25
328,7995.0,16,6,37.5%,4,7,43.8%,1,6.3%,2
329,7471.0,13,6,46.2%,5,8,61.5%,2,15.4%,1
330,1794.0,70,57,81.4%,56,59,84.3%,2,2.9%,1
331,1623.0,43,29,67.4%,29,29,67.4%,0,0.0%,0
332,3541.0,179,129,72.1%,105,134,74.9%,5,2.8%,24
333,6583.0,84,61,72.6%,43,64,76.2%,3,3.6%,18
334,2686.0,130,95,73.1%,92,101,77.7%,6,4.6%,3
335,685.0,57,49,86.0%,44,49,86.0%,0,0.0%,5
336,6181.0,81,54,66.7%,54,54,66.7%,0,0.0%,0
337,1164.0,132,84,63.6%,71,85,64.4%,1,0.8%,13
338,3040.0,67,50,74.6%,48,50,74.6%,0,0.0%,2
339,5017.0,236,213,90.3%,210,216,91.5%,3,1.3%,3
340,3045.0,178,146,82.0%,145,149,83.7%,3,1.7%,1
341,4044.0,144,100,69.4%,89,107,74.3%,7,4.9%,11
342,4951.0,282,245,86.9%,234,246,87.2%,1,0.4%,11
343,1062.0,57,51,89.5%,45,51,89.5%,0,0.0%,6
344,1550.0,88,60,68.2%,40,64,72.7%,4,4.5%,20
345,6936.0,143,100,69.9%,100,100,69.9%,0,0.0%,0
346,4458.0,182,138,75.8%,128,143,78.6%,5,2.7%,10
347,7944.0,111,62,55.9%,53,66,59.5%,4,3.6%,9
348,4049.0,120,77,64.2%,69,86,71.7%,9,7.5%,8
349,254.0,477,452,94.8%,449,452,94.8%,0,0.0%,3
350,6610.0,259,198,76.4%,182,210,81.1%,12,4.6%,16
351,7546.0,16,15,93.8%,14,15,93.8%,0,0.0%,1
352,3048.0,79,54,68.4%,54,57,72.2%,3,3.8%,0
353,3495.0,377,322,85.4%,322,323,85.7%,1,0.3%,0
354,6455.0,742,626,84.4%,624,659,88.8%,33,4.4%,2
355,7732.0,25,11,44.0%,11,11,44.0%,0,0.0%,0
356,2689.0,83,74,89.2%,74,76,91.6%,2,2.4%,0
357,695.0,121,95,78.5%,83,99,81.8%,4,3.3%,12
358,2704.0,202,165,81.7%,142,165,81.7%,0,0.0%,23
359,1084.0,115,110,95.7%,109,110,95.7%,0,0.0%,1
360,4469.0,130,95,73.1%,94,95,73.1%,0,0.0%,1
361,7829.0,68,68,100.0%,67,68,100.0%,0,0.0%,1
362,7930.0,95,64,67.4%,55,71,74.7%,7,7.4%,9
363,3321.0,2,0,0.0%,0,1,50.0%,1,50.0%,0
364,6729.0,393,264,67.2%,259,286,72.8%,22,5.6%,5
365,6998.0,43,29,67.4%,28,29,67.4%,0,0.0%,1
366,6793.0,690,650,94.2%,643,650,94.2%,0,0.0%,7
367,1489.0,54,31,57.4%,31,31,57.4%,0,0.0%,0
368,6145.0,159,118,74.2%,107,124,78.0%,6,3.8%,11
369,7101.0,392,323,82.4%,318,336,85.7%,13,3.3%,5
370,5345.0,1037,920,88.7%,898,936,90.3%,16,1.5%,22
371,2446.0,253,183,72.3%,174,197,77.9%,14,5.5%,9
372,3883.0,139,87,62.6%,79,98,70.5%,11,7.9%,8
373,3988.0,98,59,60.2%,56,74,75.5%,15,15.3%,3
374,3505.0,455,377,82.9%,364,377,82.9%,0,0.0%,13
375,964.0,67,48,71.6%,48,53,79.1%,5,7.5%,0
376,4577.0,230,157,68.3%,132,163,70.9%,6,2.6%,25
377,747.0,95,58,61.1%,50,67,70.5%,9,9.5%,8
378,6201.0,79,48,60.8%,42,53,67.1%,5,6.3%,6
379,2760.0,207,113,54.6%,113,129,62.3%,16,7.7%,0
380,2818.0,157,126,80.3%,123,127,80.9%,1,0.6%,3
381,3875.0,47,18,38.3%,18,19,40.4%,1,2.1%,0
382,4058.0,57,37,64.9%,37,39,68.4%,2,3.5%,0
383,6372.0,37,23,62.2%,22,23,62.2%,0,0.0%,1
384,6373.0,88,57,64.8%,57,63,71.6%,6,6.8%,0
385,6345.0,245,168,68.6%,157,178,72.7%,10,4.1%,11
386,53.0,103,86,83.5%,78,87,84.5%,1,1.0%,8
387,7562.0,30,26,86.7%,22,26,86.7%,0,0.0%,4
388,2958.0,94,78,83.0%,78,84,89.4%,6,6.4%,0
389,6745.0,135,101,74.8%,76,106,78.5%,5,3.7%,25
390,2821.0,181,156,86.2%,148,158,87.3%,2,1.1%,8
391,4717.0,416,347,83.4%,320,348,83.7%,1,0.2%,27
392,7665.0,166,144,86.7%,138,163,98.2%,19,11.4%,6
393,1414.0,200,132,66.0%,124,144,72.0%,12,6.0%,8
394,4931.0,200,137,68.5%,130,148,74.0%,11,5.5%,7
395,2449.0,79,57,72.2%,55,62,78.5%,5,6.3%,2
396,6318.0,164,137,83.5%,131,141,86.0%,4,2.4%,6
397,3877.0,53,31,58.5%,31,33,62.3%,2,3.8%,0
398,3107.0,73,41,56.2%,37,42,57.5%,1,1.4%,4
399,1406.0,284,252,88.7%,246,258,90.8%,6,2.1%,6
400,1420.0,269,218,81.0%,211,225,83.6%,7,2.6%,7
401,7690.0,122,65,53.3%,50,69,56.6%,4,3.3%,15
402,1094.0,180,137,76.1%,135,140,77.8%,3,1.7%,2
403,4734.0,122,95,77.9%,95,101,82.8%,6,4.9%,0
404,2766.0,219,163,74.4%,150,165,75.3%,2,0.9%,13
405,6693.0,131,103,78.6%,97,110,84.0%,7,5.3%,6
406,2829.0,773,675,87.3%,670,676,87.5%,1,0.1%,5
407,6439.0,159,124,78.0%,122,127,79.9%,3,1.9%,2
408,1213.0,164,95,57.9%,91,95,57.9%,0,0.0%,4
409,309.0,402,283,70.4%,277,293,72.9%,10,2.5%,6
410,2633.0,474,327,69.0%,294,333,70.3%,6,1.3%,33
411,1629.0,90,13,14.4%,13,13,14.4%,0,0.0%,0
412,6942.0,122,63,51.6%,52,66,54.1%,3,2.5%,11
413,6136.0,112,82,73.2%,78,87,77.7%,5,4.5%,4
414,1915.0,292,252,86.3%,245,267,91.4%,15,5.1%,7
415,1100.0,551,461,83.7%,458,485,88.0%,24,4.4%,3
416,2345.0,64,38,59.4%,33,41,64.1%,3,4.7%,5
417,6231.0,125,86,68.8%,81,87,69.6%,1,0.8%,5
418,4682.0,858,765,89.2%,760,777,90.6%,12,1.4%,5
419,7650.0,863,567,65.7%,532,615,71.3%,48,5.6%,35
420,7821.0,38,31,81.6%,26,33,86.8%,2,5.3%,5
421,7819.0,330,215,65.2%,215,259,78.5%,44,13.3%,0
422,7687.0,98,50,51.0%,50,55,56.1%,5,5.1%,0
423,6648.0,390,347,89.0%,329,355,91.0%,8,2.1%,18
424,2649.0,154,95,61.7%,93,107,69.5%,12,7.8%,2
425,3328.0,364,322,88.5%,320,323,88.7%,1,0.3%,2
426,7770.0,63,23,36.5%,20,23,36.5%,0,0.0%,3
427,5083.0,356,316,88.8%,313,317,89.0%,1,0.3%,3
428,7587.0,96,88,91.7%,79,89,92.7%,1,1.0%,9
429,3847.0,223,127,57.0%,119,127,57.0%,0,0.0%,8
430,7070.0,147,143,97.3%,139,144,98.0%,1,0.7%,4
431,3840.0,173,67,38.7%,54,68,39.3%,1,0.6%,13
432,4728.0,44,23,52.3%,23,34,77.3%,11,25.0%,0
433,7023.0,147,0,0.0%,0,0,0.0%,0,0.0%,0
434,3848.0,503,495,98.4%,495,497,98.8%,2,0.4%,0
435,7781.0,67,51,76.1%,47,53,79.1%,2,3.0%,4
436,6996.0,156,120,76.9%,118,123,78.8%,3,1.9%,2
437,3841.0,169,149,88.2%,142,154,91.1%,5,3.0%,7
438,3787.0,48,1,2.1%,1,1,2.1%,0,0.0%,0
439,3849.0,309,181,58.6%,180,213,68.9%,32,10.4%,1
440,3816.0,234,109,46.6%,109,119,50.9%,10,4.3%,0
441,7240.0,50,0,0.0%,0,0,0.0%,0,0.0%,0
442,3850.0,317,116,36.6%,111,128,40.4%,12,3.8%,5
443,3851.0,90,1,1.1%,1,1,1.1%,0,0.0%,0
444,6822.0,146,134,91.8%,130,139,95.2%,5,3.4%,4
445,3818.0,147,121,82.3%,115,130,88.4%,9,6.1%,6
446,7664.0,57,54,94.7%,54,54,94.7%,0,0.0%,0
447,3852.0,174,116,66.7%,92,122,70.1%,6,3.4%,24
448,3843.0,226,216,95.6%,215,218,96.5%,2,0.9%,1
449,3853.0,257,0,0.0%,0,0,0.0%,0,0.0%,0
450,7852.0,76,46,60.5%,46,55,72.4%,9,11.8%,0
451,7855.0,46,17,37.0%,17,20,43.5%,3,6.5%,0
452,7851.0,73,49,67.1%,49,51,69.9%,2,2.7%,0
453,6675.0,228,152,66.7%,152,176,77.2%,24,10.5%,0
454,7810.0,73,52,71.2%,49,56,76.7%,4,5.5%,3
455,7811.0,65,62,95.4%,61,62,95.4%,0,0.0%,1
456,3845.0,263,123,46.8%,120,157,59.7%,34,12.9%,3
457,3842.0,234,172,73.5%,169,198,84.6%,26,11.1%,3
458,3808.0,114,114,100.0%,114,114,100.0%,0,0.0%,0
459,7815.0,50,48,96.0%,44,49,98.0%,1,2.0%,4
460,3855.0,646,522,80.8%,485,542,83.9%,20,3.1%,37
461,7853.0,95,49,51.6%,49,53,55.8%,4,4.2%,0
462,7854.0,116,90,77.6%,82,96,82.8%,6,5.2%,8
463,3857.0,315,230,73.0%,194,259,82.2%,29,9.2%,36
464,6548.0,70,61,87.1%,60,64,91.4%,3,4.3%,1
465,7808.0,74,56,75.7%,51,58,78.4%,2,2.7%,5
466,7782.0,63,63,100.0%,63,63,100.0%,0,0.0%,0
467,7780.0,64,0,0.0%,0,0,0.0%,0,0.0%,0
468,3858.0,115,79,68.7%,77,80,69.6%,1,0.9%,2
469,7814.0,11,0,0.0%,0,0,0.0%,0,0.0%,0
470,7850.0,55,50,90.9%,50,51,92.7%,1,1.8%,0
471,7812.0,62,60,96.8%,57,60,96.8%,0,0.0%,3
472,7813.0,64,0,0.0%,0,0,0.0%,0,0.0%,0
473,6522.0,43,0,0.0%,0,0,0.0%,0,0.0%,0
474,3844.0,144,88,61.1%,79,89,61.8%,1,0.7%,9
475,3861.0,111,97,87.4%,91,97,87.4%,0,0.0%,6
476,7245.0,114,90,78.9%,87,96,84.2%,6,5.3%,3
477,3859.0,200,77,38.5%,75,78,39.0%,1,0.5%,2
478,7255.0,113,67,59.3%,67,67,59.3%,0,0.0%,0
479,7072.0,118,80,67.8%,77,92,78.0%,12,10.2%,3
480,6523.0,218,102,46.8%,94,106,48.6%,4,1.8%,8
481,7252.0,70,38,54.3%,38,38,54.3%,0,0.0%,0
482,6527.0,377,239,63.4%,218,250,66.3%,11,2.9%,21
483,3860.0,196,0,0.0%,0,0,0.0%,0,0.0%,0
484,3728.0,17,3,17.6%,3,6,35.3%,3,17.6%,0
485,7737.0,123,63,51.2%,63,77,62.6%,14,11.4%,0
486,1560.0,128,79,61.7%,78,100,78.1%,21,16.4%,1
487,1426.0,204,183,89.7%,180,184,90.2%,1,0.5%,3
488,3910.0,144,72,50.0%,66,83,57.6%,11,7.6%,6
489,315.0,332,0,0.0%,0,0,0.0%,0,0.0%,0
490,409.0,354,272,76.8%,269,278,78.5%,6,1.7%,3
491,6915.0,246,179,72.8%,159,180,73.2%,1,0.4%,20
492,412.0,161,115,71.4%,99,115,71.4%,0,0.0%,16
493,6811.0,24,0,0.0%,0,0,0.0%,0,0.0%,0
494,415.0,115,52,45.2%,52,55,47.8%,3,2.6%,0
495,6047.0,8,1,12.5%,0,6,75.0%,5,62.5%,1
496,422.0,96,73,76.0%,68,75,78.1%,2,2.1%,5
497,424.0,91,71,78.0%,70,72,79.1%,1,1.1%,1
498,416.0,188,124,66.0%,118,124,66.0%,0,0.0%,6
499,6664.0,6,0,0.0%,0,0,0.0%,0,0.0%,0
500,7103.0,135,122,90.4%,119,122,90.4%,0,0.0%,3
501,425.0,218,141,64.7%,140,141,64.7%,0,0.0%,1
502,6873.0,1,0,0.0%,0,0,0.0%,0,0.0%,0
503,420.0,73,50,68.5%,48,50,68.5%,0,0.0%,2
504,5058.0,276,219,79.3%,206,228,82.6%,9,3.3%,13
505,3210.0,467,385,82.4%,382,400,85.7%,15,3.2%,3
506,435.0,345,306,88.7%,290,312,90.4%,6,1.7%,16
507,7771.0,8,6,75.0%,6,6,75.0%,0,0.0%,0
508,3216.0,490,353,72.0%,341,360,73.5%,7,1.4%,12
509,7738.0,481,370,76.9%,359,379,78.8%,9,1.9%,11
510,3111.0,95,61,64.2%,56,62,65.3%,1,1.1%,5
511,1270.0,62,45,72.6%,41,46,74.2%,1,1.6%,4
512,3338.0,183,163,89.1%,159,167,91.3%,4,2.2%,4
513,3348.0,146,111,76.0%,105,124,84.9%,13,8.9%,6
514,3924.0,272,197,72.4%,178,199,73.2%,2,0.7%,19
515,7540.0,134,132,98.5%,131,132,98.5%,0,0.0%,1
516,6165.0,214,146,68.2%,122,162,75.7%,16,7.5%,24
517,2350.0,82,56,68.3%,44,60,73.2%,4,4.9%,12
518,448.0,125,106,84.8%,106,114,91.2%,8,6.4%,0
519,1128.0,409,341,83.4%,335,358,87.5%,17,4.2%,6
520,1921.0,285,261,91.6%,260,261,91.6%,0,0.0%,1
521,859.0,760,433,57.0%,429,481,63.3%,48,6.3%,4
522,4598.0,360,251,69.7%,208,267,74.2%,16,4.4%,43
523,1495.0,92,69,75.0%,69,69,75.0%,0,0.0%,0
524,7636.0,47,43,91.5%,41,44,93.6%,1,2.1%,2
525,3165.0,105,76,72.4%,65,77,73.3%,1,1.0%,11
526,7941.0,153,116,75.8%,115,124,81.0%,8,5.2%,1
527,1989.0,68,48,70.6%,48,48,70.6%,0,0.0%,0
528,1934.0,527,389,73.8%,387,439,83.3%,50,9.5%,2
529,7019.0,232,197,84.9%,193,202,87.1%,5,2.2%,4
530,700.0,147,107,24.2%,100,114,25.8%,7,1.6%,7
531,2496.0,102,79,77.5%,79,83,81.4%,4,3.9%,0
532,6928.0,90,73,81.1%,68,73,81.1%,0,0.0%,5
533,7629.0,32,19,59.4%,19,23,71.9%,4,12.5%,0
534,8000.0,83,49,59.0%,44,50,60.2%,1,1.2%,5
535,6210.0,82,50,61.0%,44,62,75.6%,12,14.6%,6
536,1942.0,349,315,90.3%,311,326,93.4%,11,3.2%,4
537,5169.0,214,153,71.5%,140,173,80.8%,20,9.3%,13
538,2833.0,152,130,85.5%,130,133,87.5%,3,2.0%,0
539,4002.0,36,21,58.3%,20,24,66.7%,3,8.3%,1
540,5352.0,198,168,84.8%,168,171,86.4%,3,1.5%,0
541,965.0,80,55,68.8%,55,56,70.0%,1,1.3%,0
542,5264.0,97,66,68.0%,64,75,77.3%,9,9.3%,2
543,864.0,154,117,76.0%,109,121,78.6%,4,2.6%,8
544,7124.0,32,31,96.9%,30,31,96.9%,0,0.0%,1
545,6413.0,423,313,74.0%,263,329,77.8%,16,3.8%,50
546,2489.0,256,211,82.4%,211,212,82.8%,1,0.4%,0
547,3969.0,190,141,74.2%,141,146,76.8%,5,2.6%,0
548,1183.0,537,476,88.6%,448,477,88.8%,1,0.2%,28
549,4006.0,49,34,69.4%,30,34,69.4%,0,0.0%,4
550,460.0,444,353,79.5%,339,358,80.6%,5,1.1%,14
551,7893.0,165,94,57.0%,89,95,57.6%,1,0.6%,5
552,6800.0,38,18,47.4%,18,23,60.5%,5,13.2%,0
553,5246.0,137,85,62.0%,78,91,66.4%,6,4.4%,7
554,3124.0,93,81,87.1%,72,81,87.1%,0,0.0%,9
555,3940.0,89,57,64.0%,50,63,70.8%,6,6.7%,7
556,2708.0,108,85,78.7%,85,87,80.6%,2,1.9%,0
557,3569.0,214,126,58.9%,110,128,59.8%,2,0.9%,16
558,5221.0,256,179,69.9%,169,179,69.9%,0,0.0%,10
559,1172.0,175,156,89.1%,156,157,89.7%,1,0.6%,0
560,3117.0,90,55,61.1%,55,55,61.1%,0,0.0%,0
561,2658.0,279,193,69.2%,178,200,71.7%,7,2.5%,15
562,4015.0,208,117,56.3%,104,119,57.2%,2,1.0%,13
563,4722.0,4,0,0.0%,0,0,0.0%,0,0.0%,0
564,3354.0,505,430,85.1%,426,439,86.9%,9,1.8%,4
565,440.0,141,118,83.7%,100,120,85.1%,2,1.4%,18
566,1177.0,220,179,81.4%,173,184,83.6%,5,2.3%,6
567,4602.0,211,174,82.5%,145,177,83.9%,3,1.4%,29
568,470.0,158,146,92.4%,139,147,93.0%,1,0.6%,7
569,6328.0,163,125,76.7%,123,126,77.3%,1,0.6%,2
570,467.0,158,131,82.9%,129,132,83.5%,1,0.6%,2
571,714.0,108,95,88.0%,88,95,88.0%,0,0.0%,7
572,4608.0,286,216,75.5%,200,222,77.6%,6,2.1%,16
573,3056.0,108,63,58.3%,63,66,61.1%,3,2.8%,0
574,6516.0,259,164,63.3%,153,180,69.5%,16,6.2%,11
575,2284.0,35,13,37.1%,11,14,40.0%,1,2.9%,2
576,1627.0,101,86,85.1%,83,87,86.1%,1,1.0%,3
577,2253.0,59,35,59.3%,30,37,62.7%,2,3.4%,5
578,2313.0,112,75,67.0%,61,77,68.8%,2,1.8%,14
579,2839.0,227,195,85.9%,194,202,89.0%,7,3.1%,1
580,4064.0,47,28,59.6%,28,33,70.2%,5,10.6%,0
581,4068.0,64,39,60.9%,39,42,65.6%,3,4.7%,0
582,4071.0,41,25,61.0%,22,25,61.0%,0,0.0%,3
583,4614.0,247,191,77.3%,184,203,82.2%,12,4.9%,7
584,6191.0,177,119,67.2%,119,140,79.1%,21,11.9%,0
585,7648.0,3,0,0.0%,0,0,0.0%,0,0.0%,0
586,941.0,165,38,23.0%,38,41,24.8%,3,1.8%,0
587,4623.0,257,181,70.4%,158,201,78.2%,20,7.8%,23
588,1950.0,255,236,92.5%,236,238,93.3%,2,0.8%,0
589,3376.0,155,139,89.7%,139,142,91.6%,3,1.9%,0
590,3367.0,503,450,89.5%,439,457,90.9%,7,1.4%,11
591,1364.0,596,521,87.4%,506,523,87.8%,2,0.3%,15
592,196.0,143,114,79.7%,104,116,81.1%,2,1.4%,10
593,1801.0,82,49,59.8%,49,53,64.6%,4,4.9%,0
594,477.0,110,66,60.0%,45,67,60.9%,1,0.9%,21
595,3224.0,358,338,94.4%,338,338,94.4%,0,0.0%,0
596,7635.0,20,10,50.0%,10,10,50.0%,0,0.0%,0
597,4030.0,64,42,65.6%,42,47,73.4%,5,7.8%,0
598,7567.0,38,6,15.8%,5,6,15.8%,0,0.0%,1
599,4054.0,66,43,65.2%,43,47,71.2%,4,6.1%,0
600,1806.0,224,215,96.0%,215,215,96.0%,0,0.0%,0
601,3589.0,150,106,70.7%,106,106,70.7%,0,0.0%,0
602,5070.0,157,142,90.4%,134,145,92.4%,3,1.9%,8
603,7833.0,29,13,44.8%,11,14,48.3%,1,3.4%,2
604,1668.0,147,100,68.0%,79,103,70.1%,3,2.0%,21
605,5208.0,146,90,61.6%,87,96,65.8%,6,4.1%,3
606,1423.0,490,467,95.3%,467,471,96.1%,4,0.8%,0
607,6012.0,280,201,71.8%,196,211,75.4%,10,3.6%,5
608,3957.0,84,49,58.3%,40,58,69.0%,9,10.7%,9
609,1000.0,129,95,73.6%,90,104,80.6%,9,7.0%,5
610,4670.0,144,96,66.7%,86,99,68.8%,3,2.1%,10
611,5271.0,208,149,71.6%,144,152,73.1%,3,1.4%,5
612,6216.0,26,11,42.3%,9,12,46.2%,1,3.8%,2
613,7762.0,54,13,24.1%,9,14,25.9%,1,1.9%,4
614,6280.0,185,98,53.0%,85,105,56.8%,7,3.8%,13
615,753.0,74,42,56.8%,36,49,66.2%,7,9.5%,6
616,873.0,276,222,80.4%,206,222,80.4%,0,0.0%,16
617,949.0,120,90,75.0%,88,93,77.5%,3,2.5%,2
618,2712.0,68,63,92.6%,58,66,97.1%,3,4.4%,5
619,2075.0,81,54,66.7%,49,57,70.4%,3,3.7%,5
620,1501.0,51,36,70.6%,36,36,70.6%,0,0.0%,0
621,2184.0,208,127,61.1%,111,130,62.5%,3,1.4%,16
622,1443.0,343,0,0.0%,0,0,0.0%,0,0.0%,0
623,2358.0,78,65,83.3%,65,66,84.6%,1,1.3%,0
624,21.0,135,86,63.7%,74,87,64.4%,1,0.7%,12
625,1972.0,803,602,75.0%,598,673,83.8%,71,8.8%,4
626,6340.0,83,55,66.3%,51,62,74.7%,7,8.4%,4
627,5078.0,407,388,95.3%,387,390,95.8%,2,0.5%,1
628,3395.0,266,239,89.8%,239,243,91.4%,4,1.5%,0
629,3401.0,280,223,79.6%,223,227,81.1%,4,1.4%,0
630,5081.0,230,152,66.1%,144,153,66.5%,1,0.4%,8
631,492.0,326,318,97.5%,316,321,98.5%,3,0.9%,2
632,4126.0,62,40,64.5%,40,41,66.1%,1,1.6%,0
633,6775.0,210,167,79.5%,150,169,80.5%,2,1.0%,17
634,4310.0,318,226,71.1%,196,230,72.3%,4,1.3%,30
635,5287.0,289,255,88.2%,248,258,89.3%,3,1.0%,7
636,4143.0,100,62,62.0%,62,72,72.0%,10,10.0%,0
637,4146.0,45,32,71.1%,26,34,75.6%,2,4.4%,6
638,4149.0,178,128,71.9%,125,137,77.0%,9,5.1%,3
639,4135.0,97,49,50.5%,48,57,58.8%,8,8.2%,1
640,5103.0,131,85,64.9%,70,88,67.2%,3,2.3%,15
641,2663.0,381,280,73.5%,272,286,75.1%,6,1.6%,8
642,4286.0,112,79,70.5%,62,81,72.3%,2,1.8%,17
643,6148.0,129,70,54.3%,68,86,66.7%,16,12.4%,2
644,4295.0,233,141,60.5%,138,154,66.1%,13,5.6%,3
645,2243.0,297,0,0.0%,0,0,0.0%,0,0.0%,0
646,1327.0,69,44,63.8%,44,44,63.8%,0,0.0%,0
647,4080.0,114,79,69.3%,74,80,70.2%,1,0.9%,5
648,509.0,250,209,83.6%,186,215,86.0%,6,2.4%,23
649,1566.0,93,49,52.7%,39,50,53.8%,1,1.1%,10
650,7894.0,297,264,88.9%,263,266,89.6%,2,0.7%,1
651,6734.0,330,286,86.7%,285,297,90.0%,11,3.3%,1
652,1453.0,292,249,85.3%,248,250,85.6%,1,0.3%,1
653,7136.0,66,31,47.0%,24,32,48.5%,1,1.5%,7
654,523.0,246,178,72.4%,171,179,72.8%,1,0.4%,7
655,6129.0,103,82,79.6%,76,84,81.6%,2,1.9%,6
656,536.0,287,246,85.7%,227,246,85.7%,0,0.0%,19
657,3596.0,176,118,67.0%,113,123,69.9%,5,2.8%,5
658,1732.0,365,315,86.3%,308,318,87.1%,3,0.8%,7
659,4704.0,319,262,82.1%,248,263,82.4%,1,0.3%,14
660,5059.0,99,28,28.3%,28,33,33.3%,5,5.1%,0
661,6705.0,206,169,82.0%,156,175,85.0%,6,2.9%,13
662,719.0,53,43,81.1%,41,43,81.1%,0,0.0%,2
663,6704.0,135,105,77.8%,102,115,85.2%,10,7.4%,3
664,1293.0,156,137,87.8%,132,142,91.0%,5,3.2%,5
665,2848.0,346,280,80.9%,275,284,82.1%,4,1.2%,5
666,3009.0,139,106,76.3%,104,112,80.6%,6,4.3%,2
667,3008.0,125,90,72.0%,86,91,72.8%,1,0.8%,4
668,3007.0,229,184,80.3%,176,186,81.2%,2,0.9%,8
669,555.0,75,53,70.7%,45,59,78.7%,6,8.0%,8
670,1892.0,378,187,49.5%,182,193,51.1%,6,1.6%,5
671,3914.0,83,60,72.3%,47,61,73.5%,1,1.2%,13
672,951.0,45,23,51.1%,15,24,53.3%,1,2.2%,8
673,6368.0,357,217,60.8%,212,226,63.3%,9,2.5%,5
674,2721.0,125,91,72.8%,88,103,82.4%,12,9.6%,3
675,6980.0,454,367,80.8%,363,395,87.0%,28,6.2%,4
676,3522.0,179,153,85.5%,151,158,88.3%,5,2.8%,2
677,4026.0,118,81,68.6%,63,87,73.7%,6,5.1%,18
678,3247.0,375,349,93.1%,344,350,93.3%,1,0.3%,5
679,107.0,330,240,72.7%,234,262,79.4%,22,6.7%,6
680,7512.0,67,67,100.0%,60,67,100.0%,0,0.0%,7
681,1005.0,96,74,77.1%,72,74,77.1%,0,0.0%,2
682,6390.0,205,182,88.8%,169,182,88.8%,0,0.0%,13
683,6391.0,328,250,76.2%,249,268,81.7%,18,5.5%,1
684,887.0,141,129,91.5%,126,132,93.6%,3,2.1%,3
685,4647.0,262,5,1.9%,5,5,1.9%,0,0.0%,0
686,5168.0,276,8,2.9%,6,10,3.6%,2,0.7%,2
687,7345.0,196,73,37.2%,55,83,42.3%,10,5.1%,18
688,4658.0,203,174,85.7%,165,175,86.2%,1,0.5%,9
689,4735.0,219,170,77.6%,143,171,78.1%,1,0.5%,27
690,7513.0,134,79,59.0%,72,84,62.7%,5,3.7%,7
691,,,,,,,,,,
692,,"130,647","95,939",73.4%,"91,496","99,456",76.1%,"3,517",2.7%,"4,443"
693,,,,,,,,,,
694,,,,,,,,,,
