,school number,graduate count,college bound,total college bound %,2- or 4-year college or university,2- or 4-year university %,total postsecondary bound,total postsecondary bound %,non-degree-granting postsecondary school,non-degree-granting postsecondary school %,specialized associate degree granting institution
0,3.0,139,82,58.99%,81,58.27%,87,62.59%,5,3.60%,1
2,17.0,289,190,65.74%,190,65.74%,190,65.74%,0,0.00%,0
4,6269.0,82,27,32.93%,26,31.71%,27,32.93%,0,0.00%,1
6,6271.0,202,142,70.30%,136,67.33%,154,76.24%,12,5.94%,6
8,14.0,145,92,63.45%,83,57.24%,98,67.59%,6,4.14%,9
10,21.0,134,92,68.66%,92,68.66%,96,71.64%,4,2.99%,0
12,7727.0,118,88,74.58%,88,74.58%,92,77.97%,4,3.39%,0
13,7846.0,18,5,27.78%,5,27.78%,6,33.33%,1,5.56%,0
14,7562.0,37,25,67.57%,23,62.16%,28,75.68%,3,8.11%,2
15,8308.0,58,0,0.00%,0,0.00%,0,0.00%,0,0.00%,0
16,409.0,351,51,14.53%,51,14.53%,53,15.10%,2,0.57%,0
17,412.0,150,17,11.33%,14,9.33%,19,12.67%,2,1.33%,3
18,416.0,90,55,61.11%,52,57.78%,59,65.56%,4,4.44%,3
19,6047.0,13,0,0.00%,0,0.00%,0,0.00%,0,0.00%,0
20,6664.0,3,0,0.00%,0,0.00%,0,0.00%,0,0.00%,0
21,6811.0,11,0,0.00%,0,0.00%,0,0.00%,0,0.00%,0
22,6915.0,298,22,7.38%,22,7.38%,28,9.40%,6,2.01%,0
23,8105.0,117,1,0.85%,1,0.85%,1,0.85%,0,0.00%,0
24,8106.0,129,106,82.17%,106,82.17%,108,83.72%,2,1.55%,0
25,8107.0,77,1,1.30%,1,1.30%,1,1.30%,0,0.00%,0
26,8110.0,45,11,24.44%,11,24.44%,12,26.67%,1,2.22%,0
27,8203.0,85,52,61.18%,51,60.00%,57,67.06%,5,5.88%,1
28,8300.0,20,0,0.00%,0,0.00%,0,0.00%,0,0.00%,0
30,7772.0,29,21,72.41%,21,72.41%,27,93.10%,6,20.69%,0
31,7832.0,5,3,60.00%,3,60.00%,5,100.00%,2,40.00%,0
33,29.0,64,43,67.19%,37,57.81%,43,67.19%,0,0.00%,6
34,5199.0,114,104,91.23%,104,91.23%,104,91.23%,0,0.00%,0
36,315.0,345,278,80.58%,278,80.58%,282,81.74%,4,1.16%,0
38,50.0,364,283,77.75%,283,77.75%,304,83.52%,21,5.77%,0
40,62.0,336,292,86.90%,292,86.90%,292,86.90%,0,0.00%,0
42,70.0,90,57,63.33%,56,62.22%,60,66.67%,3,3.33%,1
44,79.0,98,0,0.00%,0,0.00%,0,0.00%,0,0.00%,0
45,6706.0,255,175,68.63%,173,67.84%,176,69.02%,1,0.39%,2
47,8094.0,34,16,47.06%,16,47.06%,16,47.06%,0,0.00%,0
49,8087.0,49,34,69.39%,33,67.35%,38,77.55%,4,8.16%,1
50,513.0,115,72,62.61%,71,61.74%,72,62.61%,0,0.00%,1
51,8340.0,123,90,73.17%,71,57.72%,92,74.80%,2,1.63%,19
53,144.0,158,111,70.25%,111,70.25%,114,72.15%,3,1.90%,0
55,7648.0,6,0,0.00%,0,0.00%,0,0.00%,0,0.00%,0
56,156.0,341,272,79.77%,272,79.77%,272,79.77%,0,0.00%,0
57,170.0,231,151,65.37%,148,64.07%,154,66.67%,3,1.30%,3
59,5190.0,230,214,93.04%,213,92.61%,214,93.04%,0,0.00%,1
60,5153.0,150,94,62.67%,88,58.67%,100,66.67%,6,4.00%,6
62,5112.0,140,95,67.86%,89,63.57%,101,72.14%,6,4.29%,6
64,6105.0,208,113,54.33%,111,53.37%,121,58.17%,8,3.85%,2
65,5017.0,247,191,77.33%,188,76.11%,193,78.14%,2,0.81%,3
67,4951.0,283,224,79.15%,224,79.15%,227,80.21%,3,1.06%,0
68,254.0,425,393,92.47%,392,92.24%,394,92.71%,1,0.24%,1
70,8305.0,628,556,88.54%,556,88.54%,556,88.54%,0,0.00%,0
72,53.0,68,51,75.00%,47,69.12%,51,75.00%,0,0.00%,4
74,7101.0,290,243,83.79%,241,83.10%,248,85.52%,5,1.72%,2
75,309.0,323,213,65.94%,208,64.40%,229,70.90%,16,4.95%,5
77,435.0,288,227,78.82%,221,76.74%,232,80.56%,5,1.74%,6
79,448.0,141,120,85.11%,120,85.11%,120,85.11%,0,0.00%,0
81,6928.0,86,72,83.72%,72,83.72%,72,83.72%,0,0.00%,0
83,460.0,323,200,61.92%,200,61.92%,227,70.28%,27,8.36%,0
85,8392.0,36,13,36.11%,13,36.11%,13,36.11%,0,0.00%,0
86,8459.0,101,76,75.25%,75,74.26%,76,75.25%,0,0.00%,1
88,470.0,212,190,89.62%,190,89.62%,197,92.92%,7,3.30%,0
90,467.0,151,118,78.15%,118,78.15%,121,80.13%,3,1.99%,0
92,196.0,110,65,59.09%,62,56.36%,68,61.82%,3,2.73%,3
94,477.0,96,55,57.29%,52,54.17%,56,58.33%,1,1.04%,3
95,492.0,338,308,91.12%,307,90.83%,316,93.49%,8,2.37%,1
97,509.0,238,198,83.19%,194,81.51%,204,85.71%,6,2.52%,4
98,523.0,221,175,79.19%,168,76.02%,176,79.64%,1,0.45%,7
99,536.0,243,156,64.20%,149,61.32%,161,66.26%,5,2.06%,7
101,107.0,245,149,60.82%,149,60.82%,167,68.16%,18,7.35%,0
103,7821.0,65,31,47.69%,29,44.62%,37,56.92%,6,9.23%,2
104,8129.0,54,34,62.96%,28,51.85%,35,64.81%,1,1.85%,6
106,2320.0,60,44,73.33%,44,73.33%,45,75.00%,1,1.67%,0
108,7640.0,63,39,61.90%,37,58.73%,40,63.49%,1,1.59%,2
109,8342.0,183,82,44.81%,80,43.72%,85,46.45%,3,1.64%,2
111,594.0,113,88,77.88%,82,72.57%,89,78.76%,1,0.88%,6
112,7923.0,69,34,49.28%,30,43.48%,34,49.28%,0,0.00%,4
114,4807.0,159,52,32.70%,51,32.08%,56,35.22%,4,2.52%,1
115,7859.0,146,124,84.93%,124,84.93%,131,89.73%,7,4.79%,0
116,8086.0,57,0,0.00%,0,0.00%,0,0.00%,0,0.00%,0
117,6555.0,189,137,72.49%,118,62.43%,137,72.49%,0,0.00%,19
119,640.0,145,92,63.45%,84,57.93%,94,64.83%,2,1.38%,8
121,649.0,95,47,49.47%,41,43.16%,61,64.21%,14,14.74%,6
123,6707.0,175,137,78.29%,134,76.57%,145,82.86%,8,4.57%,3
125,8044.0,165,119,72.12%,118,71.52%,121,73.33%,2,1.21%,1
127,6563.0,94,32,34.04%,32,34.04%,32,34.04%,0,0.00%,0
129,7650.0,"1,251",475,37.97%,402,32.13%,485,38.77%,10,0.80%,73
131,675.0,139,84,60.43%,84,60.43%,91,65.47%,7,5.04%,0
133,695.0,105,61,58.10%,54,51.43%,64,60.95%,3,2.86%,7
134,700.0,119,81,68.07%,75,63.03%,81,68.07%,0,0.00%,6
135,8000.0,47,30,63.83%,23,48.94%,31,65.96%,1,2.13%,7
136,714.0,85,57,67.06%,57,67.06%,58,68.24%,1,1.18%,0
137,719.0,56,32,57.14%,30,53.57%,36,64.29%,4,7.14%,2
138,726.0,147,62,42.18%,62,42.18%,68,46.26%,6,4.08%,0
139,732.0,110,74,67.27%,63,57.27%,81,73.64%,7,6.36%,11
140,7897.0,97,38,39.18%,38,39.18%,44,45.36%,6,6.19%,0
141,8436.0,67,40,59.70%,40,59.70%,41,61.19%,1,1.49%,0
143,8154.0,15,4,26.67%,3,20.00%,4,26.67%,0,0.00%,1
144,753.0,70,29,41.43%,27,38.57%,30,42.86%,1,1.43%,2
146,8155.0,93,23,24.73%,23,24.73%,28,30.11%,5,5.38%,0
147,820.0,67,45,67.16%,45,67.16%,46,68.66%,1,1.49%,0
149,6306.0,480,334,69.58%,329,68.54%,341,71.04%,7,1.46%,5
151,6308.0,112,74,66.07%,74,66.07%,74,66.07%,0,0.00%,0
152,777.0,213,160,75.12%,153,71.83%,161,75.59%,1,0.47%,7
154,4810.0,257,189,73.54%,189,73.54%,194,75.49%,5,1.95%,0
156,788.0,323,205,63.47%,201,62.23%,210,65.02%,5,1.55%,4
158,5023.0,206,149,72.33%,149,72.33%,149,72.33%,0,0.00%,0
160,802.0,300,202,67.33%,202,67.33%,210,70.00%,8,2.67%,0
161,808.0,177,112,63.28%,103,58.19%,112,63.28%,0,0.00%,9
163,816.0,101,66,65.35%,65,64.36%,69,68.32%,3,2.97%,1
165,6610.0,302,216,71.52%,193,63.91%,216,71.52%,0,0.00%,23
167,6318.0,130,88,67.69%,88,67.69%,90,69.23%,2,1.54%,0
169,8116.0,913,347,38.01%,311,34.06%,353,38.66%,6,0.66%,36
171,864.0,143,99,69.23%,99,69.23%,103,72.03%,4,2.80%,0
173,4670.0,117,66,56.41%,66,56.41%,71,60.68%,5,4.27%,0
175,873.0,259,194,74.90%,180,69.50%,195,75.29%,1,0.39%,14
177,6980.0,456,255,55.92%,254,55.70%,258,56.58%,3,0.66%,1
179,887.0,158,128,81.01%,127,80.38%,128,81.01%,0,0.00%,1
181,7720.0,30,15,50.00%,15,50.00%,16,53.33%,1,3.33%,0
182,913.0,482,271,56.22%,252,52.28%,287,59.54%,16,3.32%,19
183,917.0,100,61,61.00%,61,61.00%,61,61.00%,0,0.00%,0
184,921.0,61,28,45.90%,20,32.79%,28,45.90%,0,0.00%,8
185,5207.0,267,166,62.17%,164,61.42%,172,64.42%,6,2.25%,2
187,941.0,140,73,52.14%,70,50.00%,79,56.43%,6,4.29%,3
189,949.0,127,85,66.93%,81,63.78%,87,68.50%,2,1.57%,4
190,951.0,33,16,48.48%,16,48.48%,16,48.48%,0,0.00%,0
191,958.0,147,70,47.62%,69,46.94%,70,47.62%,0,0.00%,1
192,988.0,78,30,38.46%,30,38.46%,35,44.87%,5,6.41%,0
194,964.0,56,34,60.71%,34,60.71%,35,62.50%,1,1.79%,0
195,965.0,65,42,64.62%,41,63.08%,44,67.69%,2,3.08%,1
196,5208.0,100,66,66.00%,61,61.00%,68,68.00%,2,2.00%,5
197,1000.0,100,57,57.00%,57,57.00%,58,58.00%,1,1.00%,0
198,1005.0,85,48,56.47%,45,52.94%,50,58.82%,2,2.35%,3
199,7726.0,25,5,20.00%,5,20.00%,7,28.00%,2,8.00%,0
200,5116.0,465,283,60.86%,276,59.35%,290,62.37%,7,1.51%,7
202,1014.0,50,34,68.00%,34,68.00%,36,72.00%,2,4.00%,0
204,1029.0,375,206,54.93%,206,54.93%,225,60.00%,19,5.07%,0
206,1030.0,341,188,55.13%,186,54.55%,207,60.70%,19,5.57%,2
207,1040.0,389,301,77.38%,300,77.12%,307,78.92%,6,1.54%,1
209,1043.0,488,420,86.07%,419,85.86%,422,86.48%,2,0.41%,1
210,5133.0,490,451,92.04%,451,92.04%,453,92.45%,2,0.41%,0
211,7790.0,559,491,87.84%,490,87.66%,495,88.55%,4,0.72%,1
213,5096.0,387,347,89.66%,345,89.15%,352,90.96%,5,1.29%,2
214,7749.0,495,436,88.08%,435,87.88%,439,88.69%,3,0.61%,1
216,7568.0,59,44,74.58%,44,74.58%,48,81.36%,4,6.78%,0
218,8381.0,54,35,64.81%,34,62.96%,36,66.67%,1,1.85%,1
220,6455.0,626,512,81.79%,512,81.79%,543,86.74%,31,4.95%,0
222,1084.0,100,95,95.00%,95,95.00%,95,95.00%,0,0.00%,0
223,1094.0,141,114,80.85%,114,80.85%,117,82.98%,3,2.13%,0
225,1100.0,521,368,70.63%,366,70.25%,374,71.79%,6,1.15%,2
227,4682.0,749,575,76.77%,573,76.50%,587,78.37%,12,1.60%,2
229,1128.0,416,302,72.60%,300,72.12%,305,73.32%,3,0.72%,2
230,8344.0,429,357,83.22%,352,82.05%,363,84.62%,6,1.40%,5
232,1154.0,82,55,67.07%,51,62.20%,60,73.17%,5,6.10%,4
234,1159.0,245,218,88.98%,218,88.98%,219,89.39%,1,0.41%,0
236,1164.0,84,51,60.71%,43,51.19%,54,64.29%,3,3.57%,8
237,1172.0,164,89,54.27%,89,54.27%,91,55.49%,2,1.22%,0
239,1177.0,216,82,37.96%,82,37.96%,82,37.96%,0,0.00%,0
240,8318.0,564,506,89.72%,476,84.40%,510,90.43%,4,0.71%,30
242,5135.0,41,27,65.85%,23,56.10%,27,65.85%,0,0.00%,4
244,5212.0,106,75,70.75%,68,64.15%,77,72.64%,2,1.89%,7
245,1208.0,132,89,67.42%,88,66.67%,92,69.70%,3,2.27%,1
247,5136.0,42,22,52.38%,21,50.00%,26,61.90%,4,9.52%,1
248,1225.0,45,6,13.33%,6,13.33%,6,13.33%,0,0.00%,0
249,8382.0,123,76,61.79%,60,48.78%,78,63.41%,2,1.63%,16
250,1251.0,171,87,50.88%,83,48.54%,88,51.46%,1,0.58%,4
251,8314.0,8,0,0.00%,0,0.00%,0,0.00%,0,0.00%,0
253,6201.0,81,58,71.60%,53,65.43%,63,77.78%,5,6.17%,5
254,1213.0,121,70,57.85%,69,57.02%,81,66.94%,11,9.09%,1
256,1270.0,63,41,65.08%,36,57.14%,41,65.08%,0,0.00%,5
257,7941.0,129,96,74.42%,87,67.44%,98,75.97%,2,1.55%,9
259,8379.0,125,95,76.00%,95,76.00%,95,76.00%,0,0.00%,0
260,1299.0,42,16,38.10%,14,33.33%,17,40.48%,1,2.38%,2
261,4870.0,106,29,27.36%,28,26.42%,33,31.13%,4,3.77%,1
262,1307.0,126,100,79.37%,97,76.98%,105,83.33%,5,3.97%,3
264,1315.0,157,100,63.69%,96,61.15%,100,63.69%,0,0.00%,4
266,4734.0,119,94,78.99%,94,78.99%,94,78.99%,0,0.00%,0
268,8348.0,77,46,59.74%,45,58.44%,47,61.04%,1,1.30%,1
269,1327.0,51,27,52.94%,27,52.94%,27,52.94%,0,0.00%,0
271,1335.0,127,58,45.67%,58,45.67%,65,51.18%,7,5.51%,0
273,1343.0,190,121,63.68%,119,62.63%,122,64.21%,1,0.53%,2
274,6231.0,96,61,63.54%,55,57.29%,61,63.54%,0,0.00%,6
275,1364.0,552,456,82.61%,451,81.70%,457,82.79%,1,0.18%,5
276,7691.0,260,116,44.62%,116,44.62%,137,52.69%,21,8.08%,0
277,7721.0,87,69,79.31%,69,79.31%,70,80.46%,1,1.15%,0
279,7819.0,337,228,67.66%,209,62.02%,240,71.22%,12,3.56%,19
280,1367.0,424,89,20.99%,84,19.81%,90,21.23%,1,0.24%,5
282,5012.0,412,253,61.41%,243,58.98%,286,69.42%,33,8.01%,10
283,8415.0,32,10,31.25%,10,31.25%,12,37.50%,2,6.25%,0
285,1387.0,384,283,73.70%,283,73.70%,289,75.26%,6,1.56%,0
286,7759.0,429,309,72.03%,309,72.03%,312,72.73%,3,0.70%,0
287,8174.0,206,205,99.51%,205,99.51%,205,99.51%,0,0.00%,0
289,8394.0,85,0,0.00%,0,0.00%,0,0.00%,0,0.00%,0
290,7628.0,101,83,82.18%,83,82.18%,88,87.13%,5,4.95%,0
292,7636.0,72,68,94.44%,66,91.67%,68,94.44%,0,0.00%,2
293,1424.0,291,263,90.38%,263,90.38%,264,90.72%,1,0.34%,0
295,6482.0,324,239,73.77%,237,73.15%,244,75.31%,5,1.54%,2
297,1414.0,202,111,54.95%,110,54.46%,116,57.43%,5,2.48%,1
299,1406.0,393,330,83.97%,322,81.93%,335,85.24%,5,1.27%,8
301,1420.0,316,202,63.92%,183,57.91%,207,65.51%,5,1.58%,19
303,1426.0,234,191,81.62%,189,80.77%,199,85.04%,8,3.42%,2
305,1423.0,554,533,96.21%,533,96.21%,534,96.39%,1,0.18%,0
307,1443.0,307,273,88.93%,273,88.93%,275,89.58%,2,0.65%,0
309,1453.0,287,258,89.90%,256,89.20%,259,90.24%,1,0.35%,2
310,6734.0,286,260,90.91%,254,88.81%,260,90.91%,0,0.00%,6
311,7894.0,317,285,89.91%,284,89.59%,288,90.85%,3,0.95%,1
313,7824.0,106,37,34.91%,33,31.13%,44,41.51%,7,6.60%,4
314,4664.0,46,26,56.52%,25,54.35%,28,60.87%,2,4.35%,1
316,1475.0,53,35,66.04%,34,64.15%,35,66.04%,0,0.00%,1
318,1480.0,58,37,63.79%,34,58.62%,41,70.69%,4,6.90%,3
319,1486.0,71,33,46.48%,33,46.48%,38,53.52%,5,7.04%,0
321,1489.0,46,28,60.87%,28,60.87%,28,60.87%,0,0.00%,0
323,1495.0,61,0,0.00%,0,0.00%,0,0.00%,0,0.00%,0
324,1501.0,26,18,69.23%,15,57.69%,18,69.23%,0,0.00%,3
326,6156.0,244,139,56.97%,131,53.69%,141,57.79%,2,0.82%,8
328,6236.0,145,64,44.14%,60,41.38%,64,44.14%,0,0.00%,4
330,1529.0,70,42,60.00%,38,54.29%,46,65.71%,4,5.71%,4
331,5219.0,53,30,56.60%,30,56.60%,30,56.60%,0,0.00%,0
332,8316.0,25,18,72.00%,14,56.00%,18,72.00%,0,0.00%,4
333,1550.0,72,42,58.33%,42,58.33%,46,63.89%,4,5.56%,0
335,1560.0,111,49,44.14%,48,43.24%,49,44.14%,0,0.00%,1
336,1566.0,59,29,49.15%,25,42.37%,30,50.85%,1,1.69%,4
337,7635.0,37,13,35.14%,13,35.14%,13,35.14%,0,0.00%,0
338,6241.0,27,16,59.26%,14,51.85%,16,59.26%,0,0.00%,2
339,7589.0,232,134,57.76%,120,51.72%,142,61.21%,8,3.45%,14
340,8434.0,55,33,60.00%,29,52.73%,33,60.00%,0,0.00%,4
342,1605.0,173,108,62.43%,106,61.27%,111,64.16%,3,1.73%,2
344,1612.0,87,60,68.97%,60,68.97%,60,68.97%,0,0.00%,0
345,1619.0,127,95,74.80%,94,74.02%,99,77.95%,4,3.15%,1
347,5178.0,142,55,38.73%,49,34.51%,57,40.14%,2,1.41%,6
348,1623.0,57,34,59.65%,29,50.88%,35,61.40%,1,1.75%,5
349,1627.0,106,82,77.36%,82,77.36%,84,79.25%,2,1.89%,0
350,7567.0,18,14,77.78%,11,61.11%,14,77.78%,0,0.00%,3
351,8224.0,149,71,47.65%,66,44.30%,79,53.02%,8,5.37%,5
353,1632.0,65,26,40.00%,25,38.46%,28,43.08%,2,3.08%,1
354,1654.0,203,119,58.62%,118,58.13%,136,67.00%,17,8.37%,1
356,1629.0,66,36,54.55%,36,54.55%,36,54.55%,0,0.00%,0
357,6136.0,70,41,58.57%,38,54.29%,46,65.71%,5,7.14%,3
358,6942.0,75,39,52.00%,38,50.67%,45,60.00%,6,8.00%,1
360,1677.0,200,102,51.00%,96,48.00%,102,51.00%,0,0.00%,6
362,1682.0,99,80,80.81%,80,80.81%,80,80.81%,0,0.00%,0
363,1694.0,367,247,67.30%,242,65.94%,250,68.12%,3,0.82%,5
365,1701.0,647,445,68.78%,444,68.62%,445,68.78%,0,0.00%,1
367,1707.0,181,109,60.22%,109,60.22%,109,60.22%,0,0.00%,0
369,5098.0,271,196,72.32%,195,71.96%,203,74.91%,7,2.58%,1
371,5221.0,261,129,49.43%,122,46.74%,133,50.96%,4,1.53%,7
372,6328.0,149,92,61.74%,87,58.39%,93,62.42%,1,0.67%,5
374,7774.0,998,328,32.87%,317,31.76%,408,40.88%,80,8.02%,11
375,1745.0,432,310,71.76%,301,69.68%,311,71.99%,1,0.23%,9
376,1746.0,373,5,1.34%,5,1.34%,5,1.34%,0,0.00%,0
378,5278.0,239,118,49.37%,110,46.03%,121,50.63%,3,1.26%,8
379,4801.0,295,227,76.95%,220,74.58%,227,76.95%,0,0.00%,7
381,6330.0,63,40,63.49%,40,63.49%,40,63.49%,0,0.00%,0
382,6333.0,197,114,57.87%,114,57.87%,114,57.87%,0,0.00%,0
383,7902.0,67,66,98.51%,66,98.51%,66,98.51%,0,0.00%,0
384,8376.0,21,17,80.95%,17,80.95%,17,80.95%,0,0.00%,0
386,1776.0,260,181,69.62%,179,68.85%,183,70.38%,2,0.77%,2
387,7844.0,1,0,0.00%,0,0.00%,0,0.00%,0,0.00%,0
389,1790.0,183,121,66.12%,108,59.02%,130,71.04%,9,4.92%,13
390,1794.0,38,27,71.05%,26,68.42%,27,71.05%,0,0.00%,1
391,8278.0,47,40,85.11%,40,85.11%,40,85.11%,0,0.00%,0
392,8366.0,458,149,32.53%,123,26.86%,153,33.41%,4,0.87%,26
393,1801.0,55,35,63.64%,33,60.00%,40,72.73%,5,9.09%,2
395,1806.0,191,145,75.92%,144,75.39%,148,77.49%,3,1.57%,1
397,6340.0,77,42,54.55%,42,54.55%,42,54.55%,0,0.00%,0
398,6492.0,173,79,45.66%,79,45.66%,80,46.24%,1,0.58%,0
399,8303.0,78,56,71.79%,56,71.79%,56,71.79%,0,0.00%,0
401,1849.0,228,141,61.84%,133,58.33%,152,66.67%,11,4.82%,8
403,1869.0,391,364,93.09%,364,93.09%,364,93.09%,0,0.00%,0
405,1879.0,440,397,90.23%,394,89.55%,399,90.68%,2,0.45%,3
407,1885.0,232,136,58.62%,133,57.33%,139,59.91%,3,1.29%,3
409,1902.0,266,242,90.98%,240,90.23%,243,91.35%,1,0.38%,2
411,8258.0,46,36,78.26%,30,65.22%,39,84.78%,3,6.52%,6
412,1915.0,244,200,81.97%,199,81.56%,201,82.38%,1,0.41%,1
414,1921.0,313,264,84.35%,264,84.35%,264,84.35%,0,0.00%,0
416,1934.0,420,338,80.48%,297,70.71%,339,80.71%,1,0.24%,41
418,1942.0,277,198,71.48%,197,71.12%,201,72.56%,3,1.08%,1
420,6516.0,273,0,0.00%,0,0.00%,0,0.00%,0,0.00%,0
422,1950.0,316,276,87.34%,269,85.13%,284,89.87%,8,2.53%,7
424,1972.0,847,502,59.27%,502,59.27%,533,62.93%,31,3.66%,0
426,5287.0,243,217,89.30%,216,88.89%,218,89.71%,1,0.41%,1
427,8231.0,329,215,65.35%,196,59.57%,215,65.35%,0,0.00%,19
429,6218.0,47,30,63.83%,30,63.83%,32,68.09%,2,4.26%,0
431,1989.0,63,31,49.21%,31,49.21%,31,49.21%,0,0.00%,0
432,5169.0,168,91,54.17%,91,54.17%,96,57.14%,5,2.98%,0
433,7770.0,87,50,57.47%,33,37.93%,56,64.37%,6,6.90%,17
434,1998.0,156,71,45.51%,71,45.51%,83,53.21%,12,7.69%,0
436,7515.0,192,165,85.94%,165,85.94%,170,88.54%,5,2.60%,0
437,8417.0,461,161,34.92%,161,34.92%,161,34.92%,0,0.00%,0
439,6737.0,140,93,66.43%,93,66.43%,94,67.14%,1,0.71%,0
440,2037.0,166,104,62.65%,103,62.05%,112,67.47%,8,4.82%,1
442,2040.0,158,95,60.13%,95,60.13%,95,60.13%,0,0.00%,0
444,2043.0,106,44,41.51%,43,40.57%,45,42.45%,1,0.94%,1
446,7948.0,180,116,64.44%,112,62.22%,116,64.44%,0,0.00%,4
447,4817.0,92,47,51.09%,44,47.83%,47,51.09%,0,0.00%,3
448,8071.0,458,285,62.23%,275,60.04%,299,65.28%,14,3.06%,10
450,6145.0,108,57,52.78%,57,52.78%,60,55.56%,3,2.78%,0
452,6745.0,111,15,13.51%,15,13.51%,20,18.02%,5,4.50%,0
453,2075.0,75,37,49.33%,36,48.00%,37,49.33%,0,0.00%,1
454,6148.0,93,36,38.71%,34,36.56%,40,43.01%,4,4.30%,2
455,6001.0,245,96,39.18%,95,38.78%,118,48.16%,22,8.98%,1
456,4818.0,97,61,62.89%,53,54.64%,62,63.92%,1,1.03%,8
457,5228.0,270,145,53.70%,144,53.33%,150,55.56%,5,1.85%,1
459,2126.0,85,56,65.88%,56,65.88%,56,65.88%,0,0.00%,0
461,6600.0,196,122,62.24%,117,59.69%,125,63.78%,3,1.53%,5
463,6643.0,84,16,19.05%,14,16.67%,17,20.24%,1,1.19%,2
464,2184.0,162,84,51.85%,68,41.98%,88,54.32%,4,2.47%,16
466,6159.0,19,10,52.63%,9,47.37%,10,52.63%,0,0.00%,1
467,6161.0,20,9,45.00%,9,45.00%,9,45.00%,0,0.00%,0
469,2191.0,469,193,41.15%,193,41.15%,194,41.36%,1,0.21%,0
470,8244.0,175,65,37.14%,62,35.43%,69,39.43%,4,2.29%,3
472,2201.0,38,18,47.37%,18,47.37%,20,52.63%,2,5.26%,0
473,2206.0,201,135,67.16%,134,66.67%,140,69.65%,5,2.49%,1
475,6280.0,148,64,43.24%,55,37.16%,68,45.95%,4,2.70%,9
476,2243.0,318,141,44.34%,141,44.34%,182,57.23%,41,12.89%,0
478,6252.0,71,33,46.48%,33,46.48%,38,53.52%,5,7.04%,0
479,2246.0,18,9,50.00%,8,44.44%,9,50.00%,0,0.00%,1
480,2253.0,59,34,57.63%,34,57.63%,34,57.63%,0,0.00%,0
481,7112.0,87,59,67.82%,55,63.22%,61,70.11%,2,2.30%,4
482,5118.0,117,80,68.38%,69,58.97%,81,69.23%,1,0.85%,11
484,2280.0,46,34,73.91%,34,73.91%,36,78.26%,2,4.35%,0
485,2284.0,28,16,57.14%,16,57.14%,20,71.43%,4,14.29%,0
487,8442.0,43,22,51.16%,22,51.16%,22,51.16%,0,0.00%,0
488,2305.0,148,92,62.16%,86,58.11%,93,62.84%,1,0.68%,6
490,2308.0,62,31,50.00%,31,50.00%,34,54.84%,3,4.84%,0
491,7944.0,88,46,52.27%,45,51.14%,50,56.82%,4,4.55%,1
492,2313.0,87,40,45.98%,40,45.98%,42,48.28%,2,2.30%,0
493,7762.0,29,0,0.00%,0,0.00%,0,0.00%,0,0.00%,0
494,2353.0,35,22,62.86%,19,54.29%,22,62.86%,0,0.00%,3
495,4706.0,60,26,43.33%,25,41.67%,27,45.00%,1,1.67%,1
497,2331.0,66,40,60.61%,37,56.06%,41,62.12%,1,1.52%,3
498,2325.0,208,148,71.15%,142,68.27%,149,71.63%,1,0.48%,6
500,2339.0,88,52,59.09%,46,52.27%,54,61.36%,2,2.27%,6
501,2345.0,63,30,47.62%,30,47.62%,33,52.38%,3,4.76%,0
503,2350.0,56,33,58.93%,28,50.00%,33,58.93%,0,0.00%,5
505,2358.0,75,33,44.00%,33,44.00%,34,45.33%,1,1.33%,0
507,2362.0,74,40,54.05%,33,44.59%,41,55.41%,1,1.35%,7
509,6162.0,109,57,52.29%,53,48.62%,63,57.80%,6,5.50%,4
510,5180.0,79,24,30.38%,15,18.99%,26,32.91%,2,2.53%,9
511,6165.0,138,81,58.70%,76,55.07%,91,65.94%,10,7.25%,5
513,2394.0,91,0,0.00%,0,0.00%,0,0.00%,0,0.00%,0
514,6255.0,145,33,22.76%,28,19.31%,34,23.45%,1,0.69%,5
516,5091.0,248,211,85.08%,208,83.87%,213,85.89%,2,0.81%,3
518,2420.0,100,66,66.00%,57,57.00%,72,72.00%,6,6.00%,9
520,8312.0,116,99,85.34%,99,85.34%,99,85.34%,0,0.00%,0
522,6404.0,111,81,72.97%,81,72.97%,83,74.77%,2,1.80%,0
523,8304.0,105,64,60.95%,62,59.05%,65,61.90%,1,0.95%,2
525,2446.0,201,144,71.64%,144,71.64%,147,73.13%,3,1.49%,0
527,2449.0,49,40,81.63%,40,81.63%,40,81.63%,0,0.00%,0
529,2496.0,109,73,66.97%,73,66.97%,78,71.56%,5,4.59%,0
531,2489.0,202,128,63.37%,128,63.37%,137,67.82%,9,4.46%,0
532,6413.0,389,244,62.72%,244,62.72%,247,63.50%,3,0.77%,0
534,6775.0,177,138,77.97%,135,76.27%,138,77.97%,0,0.00%,3
535,6290.0,197,117,59.39%,113,57.36%,117,59.39%,0,0.00%,4
536,2515.0,91,31,34.07%,28,30.77%,31,34.07%,0,0.00%,3
538,2532.0,294,149,50.68%,149,50.68%,149,50.68%,0,0.00%,0
540,2539.0,213,137,64.32%,136,63.85%,137,64.32%,0,0.00%,1
542,2554.0,229,112,48.91%,111,48.47%,115,50.22%,3,1.31%,1
543,2562.0,303,184,60.73%,183,60.40%,194,64.03%,10,3.30%,1
545,6293.0,285,172,60.35%,159,55.79%,176,61.75%,4,1.40%,13
547,7538.0,23,13,56.52%,13,56.52%,13,56.52%,0,0.00%,0
548,2578.0,535,384,71.78%,364,68.04%,388,72.52%,4,0.75%,20
550,2607.0,234,179,76.50%,152,64.96%,183,78.21%,4,1.71%,27
552,2596.0,542,315,58.12%,289,53.32%,326,60.15%,11,2.03%,26
553,7922.0,128,3,2.34%,2,1.56%,3,2.34%,0,0.00%,1
555,2618.0,246,146,59.35%,146,59.35%,152,61.79%,6,2.44%,0
557,2623.0,413,319,77.24%,310,75.06%,319,77.24%,0,0.00%,9
559,2633.0,369,258,69.92%,249,67.48%,261,70.73%,3,0.81%,9
561,2649.0,113,58,51.33%,54,47.79%,68,60.18%,10,8.85%,4
563,2658.0,228,84,36.84%,84,36.84%,87,38.16%,3,1.32%,0
565,2663.0,324,223,68.83%,197,60.80%,223,68.83%,0,0.00%,26
566,2675.0,82,48,58.54%,48,58.54%,60,73.17%,12,14.63%,0
568,2680.0,80,14,17.50%,14,17.50%,14,17.50%,0,0.00%,0
569,4940.0,116,25,21.55%,23,19.83%,30,25.86%,5,4.31%,2
570,2686.0,90,64,71.11%,64,71.11%,68,75.56%,4,4.44%,0
571,2689.0,92,79,85.87%,79,85.87%,83,90.22%,4,4.35%,0
572,2704.0,151,110,72.85%,102,67.55%,113,74.83%,3,1.99%,8
574,2708.0,77,57,74.03%,52,67.53%,63,81.82%,6,7.79%,5
575,2712.0,52,33,63.46%,33,63.46%,35,67.31%,2,3.85%,0
576,2721.0,84,56,66.67%,51,60.71%,57,67.86%,1,1.19%,5
578,2725.0,104,64,61.54%,64,61.54%,66,63.46%,2,1.92%,0
580,4800.0,387,256,66.15%,238,61.50%,260,67.18%,4,1.03%,18
581,2740.0,153,99,64.71%,99,64.71%,100,65.36%,1,0.65%,0
583,5155.0,268,111,41.42%,110,41.04%,116,43.28%,5,1.87%,1
585,2760.0,158,62,39.24%,58,36.71%,66,41.77%,4,2.53%,4
587,2766.0,262,197,75.19%,195,74.43%,197,75.19%,0,0.00%,2
588,2794.0,587,278,47.36%,276,47.02%,285,48.55%,7,1.19%,2
589,2795.0,436,261,59.86%,257,58.94%,274,62.84%,13,2.98%,4
590,8412.0,96,65,67.71%,64,66.67%,70,72.92%,5,5.21%,1
592,2798.0,90,58,64.44%,57,63.33%,59,65.56%,1,1.11%,1
593,2809.0,635,494,77.80%,488,76.85%,498,78.43%,4,0.63%,6
595,8401.0,36,32,88.89%,32,88.89%,32,88.89%,0,0.00%,0
596,2818.0,104,60,57.69%,59,56.73%,60,57.69%,0,0.00%,1
598,2821.0,178,112,62.92%,112,62.92%,116,65.17%,4,2.25%,0
600,2829.0,795,657,82.64%,653,82.14%,660,83.02%,3,0.38%,4
602,8371.0,33,18,54.55%,17,51.52%,18,54.55%,0,0.00%,1
603,2833.0,127,92,72.44%,92,72.44%,92,72.44%,0,0.00%,0
605,2839.0,273,178,65.20%,178,65.20%,179,65.57%,1,0.37%,0
607,2848.0,375,207,55.20%,207,55.20%,213,56.80%,6,1.60%,0
609,8325.0,79,56,70.89%,52,65.82%,56,70.89%,0,0.00%,4
610,8125.0,44,41,93.18%,41,93.18%,43,97.73%,2,4.55%,0
611,8446.0,209,114,54.55%,114,54.55%,115,55.02%,1,0.48%,0
613,2869.0,193,153,79.27%,152,78.76%,153,79.27%,0,0.00%,1
614,5242.0,161,103,63.98%,103,63.98%,104,64.60%,1,0.62%,0
616,2891.0,123,85,69.11%,85,69.11%,88,71.54%,3,2.44%,0
618,7348.0,763,404,52.95%,395,51.77%,407,53.34%,3,0.39%,9
620,2924.0,150,100,66.67%,100,66.67%,109,72.67%,9,6.00%,0
621,2958.0,85,63,74.12%,63,74.12%,63,74.12%,0,0.00%,0
623,5058.0,249,185,74.30%,185,74.30%,203,81.53%,18,7.23%,0
625,5059.0,94,40,42.55%,38,40.43%,41,43.62%,1,1.06%,2
626,3007.0,205,149,72.68%,144,70.24%,149,72.68%,0,0.00%,5
627,3008.0,115,41,35.65%,40,34.78%,41,35.65%,0,0.00%,1
628,3009.0,131,100,76.34%,88,67.18%,100,76.34%,0,0.00%,12
629,8448.0,11,10,90.91%,10,90.91%,11,100.00%,1,9.09%,0
631,6390.0,168,140,83.33%,139,82.74%,143,85.12%,3,1.79%,1
633,6391.0,277,0,0.00%,0,0.00%,0,0.00%,0,0.00%,0
635,6364.0,125,82,65.60%,82,65.60%,84,67.20%,2,1.60%,0
637,3034.0,167,65,38.92%,65,38.92%,67,40.12%,2,1.20%,0
638,4828.0,119,86,72.27%,86,72.27%,88,73.95%,2,1.68%,0
639,3040.0,50,33,66.00%,27,54.00%,33,66.00%,0,0.00%,6
640,3045.0,139,95,68.35%,91,65.47%,98,70.50%,3,2.16%,4
641,3048.0,52,36,69.23%,33,63.46%,37,71.15%,1,1.92%,3
642,3056.0,79,46,58.23%,46,58.23%,46,58.23%,0,0.00%,0
643,6368.0,312,206,66.03%,206,66.03%,206,66.03%,0,0.00%,0
644,4691.0,171,86,50.29%,79,46.20%,100,58.48%,14,8.19%,7
646,5245.0,76,44,57.89%,44,57.89%,44,57.89%,0,0.00%,0
647,3107.0,42,21,50.00%,21,50.00%,23,54.76%,2,4.76%,0
648,3111.0,75,31,41.33%,30,40.00%,31,41.33%,0,0.00%,1
649,3117.0,55,0,0.00%,0,0.00%,0,0.00%,0,0.00%,0
650,6122.0,43,26,60.47%,22,51.16%,29,67.44%,3,6.98%,4
652,5248.0,44,18,40.91%,18,40.91%,26,59.09%,8,18.18%,0
653,3137.0,114,71,62.28%,69,60.53%,73,64.04%,2,1.75%,2
654,7506.0,31,2,6.45%,2,6.45%,2,6.45%,0,0.00%,0
655,3145.0,128,83,64.84%,80,62.50%,83,64.84%,0,0.00%,3
656,6125.0,26,14,53.85%,14,53.85%,24,92.31%,10,38.46%,0
657,3150.0,153,105,68.63%,101,66.01%,108,70.59%,3,1.96%,4
658,6126.0,43,25,58.14%,25,58.14%,26,60.47%,1,2.33%,0
659,3155.0,86,46,53.49%,46,53.49%,56,65.12%,10,11.63%,0
660,3158.0,78,40,51.28%,37,47.44%,42,53.85%,2,2.56%,3
662,3165.0,70,49,70.00%,43,61.43%,49,70.00%,0,0.00%,6
663,8093.0,103,59,57.28%,59,57.28%,59,57.28%,0,0.00%,0
664,3124.0,91,49,53.85%,46,50.55%,52,57.14%,3,3.30%,3
665,6129.0,73,54,73.97%,53,72.60%,54,73.97%,0,0.00%,1
666,8187.0,372,132,35.48%,122,32.80%,143,38.44%,11,2.96%,10
668,7866.0,16,14,87.50%,14,87.50%,14,87.50%,0,0.00%,0
669,6935.0,314,224,71.34%,220,70.06%,228,72.61%,4,1.27%,4
670,7641.0,236,149,63.14%,147,62.29%,160,67.80%,11,4.66%,2
672,3210.0,342,258,75.44%,254,74.27%,258,75.44%,0,0.00%,4
673,3216.0,325,146,44.92%,146,44.92%,151,46.46%,5,1.54%,0
674,7738.0,412,190,46.12%,183,44.42%,191,46.36%,1,0.24%,7
676,3224.0,418,145,34.69%,145,34.69%,147,35.17%,2,0.48%,0
677,7687.0,210,50,23.81%,50,23.81%,58,27.62%,8,3.81%,0
678,3241.0,596,488,81.88%,481,80.70%,488,81.88%,0,0.00%,7
679,3260.0,332,213,64.16%,208,62.65%,213,64.16%,0,0.00%,5
681,3333.0,376,325,86.44%,324,86.17%,330,87.77%,5,1.33%,1
683,3272.0,397,337,84.89%,337,84.89%,339,85.39%,2,0.50%,0
685,8049.0,47,43,91.49%,42,89.36%,43,91.49%,0,0.00%,1
686,3295.0,361,329,91.14%,329,91.14%,335,92.80%,6,1.66%,0
687,3296.0,293,265,90.44%,265,90.44%,266,90.78%,1,0.34%,0
689,4960.0,174,161,92.53%,158,90.80%,161,92.53%,0,0.00%,3
690,3305.0,345,305,88.41%,305,88.41%,307,88.99%,2,0.58%,0
692,6729.0,320,137,42.81%,131,40.94%,137,42.81%,0,0.00%,6
693,6998.0,60,15,25.00%,11,18.33%,15,25.00%,0,0.00%,4
695,5345.0,"1,005",863,85.87%,849,84.48%,868,86.37%,5,0.50%,14
697,3328.0,431,322,74.71%,311,72.16%,324,75.17%,2,0.46%,11
698,3338.0,245,69,28.16%,67,27.35%,69,28.16%,0,0.00%,2
700,3348.0,182,61,33.52%,61,33.52%,69,37.91%,8,4.40%,0
702,3354.0,502,408,81.27%,408,81.27%,409,81.47%,1,0.20%,0
704,3376.0,165,122,73.94%,122,73.94%,123,74.55%,1,0.61%,0
705,3367.0,613,533,86.95%,527,85.97%,533,86.95%,0,0.00%,6
707,5078.0,292,272,93.15%,271,92.81%,272,93.15%,0,0.00%,1
709,3395.0,284,99,34.86%,95,33.45%,99,34.86%,0,0.00%,4
711,3401.0,211,153,72.51%,151,71.56%,156,73.93%,3,1.42%,2
713,5081.0,238,156,65.55%,151,63.45%,157,65.97%,1,0.42%,5
715,3247.0,353,321,90.93%,321,90.93%,326,92.35%,5,1.42%,0
717,7858.0,602,273,45.35%,266,44.19%,328,54.49%,55,9.14%,7
719,3425.0,157,118,75.16%,109,69.43%,120,76.43%,2,1.27%,9
720,7681.0,87,79,90.80%,79,90.80%,81,93.10%,2,2.30%,0
722,3434.0,215,113,52.56%,113,52.56%,113,52.56%,0,0.00%,0
723,3465.0,600,418,69.67%,410,68.33%,420,70.00%,2,0.33%,8
724,4957.0,430,305,70.93%,297,69.07%,313,72.79%,8,1.86%,8
726,7634.0,146,100,68.49%,100,68.49%,103,70.55%,3,2.05%,0
727,3482.0,669,451,67.41%,449,67.12%,459,68.61%,8,1.20%,2
728,3495.0,366,302,82.51%,301,82.24%,314,85.79%,12,3.28%,1
729,3505.0,414,327,78.99%,311,75.12%,327,78.99%,0,0.00%,16
730,6439.0,111,77,69.37%,76,68.47%,80,72.07%,3,2.70%,1
731,5352.0,184,142,77.17%,141,76.63%,143,77.72%,1,0.54%,1
733,3522.0,159,111,69.81%,111,69.81%,111,69.81%,0,0.00%,0
735,3532.0,106,60,56.60%,60,56.60%,69,65.09%,9,8.49%,0
737,3541.0,164,80,48.78%,79,48.17%,80,48.78%,0,0.00%,1
738,6936.0,127,67,52.76%,66,51.97%,68,53.54%,1,0.79%,1
739,7893.0,171,87,50.88%,83,48.54%,87,50.88%,0,0.00%,4
740,3569.0,181,101,55.80%,92,50.83%,104,57.46%,3,1.66%,9
741,5103.0,119,35,29.41%,34,28.57%,35,29.41%,0,0.00%,1
742,6341.0,56,28,50.00%,28,50.00%,28,50.00%,0,0.00%,0
743,7930.0,61,33,54.10%,32,52.46%,33,54.10%,0,0.00%,1
744,3589.0,114,65,57.02%,65,57.02%,65,57.02%,0,0.00%,0
746,3596.0,153,80,52.29%,79,51.63%,81,52.94%,1,0.65%,1
748,7744.0,68,45,66.18%,41,60.29%,52,76.47%,7,10.29%,4
749,8083.0,36,36,100.00%,35,97.22%,36,100.00%,0,0.00%,1
750,7678.0,72,52,72.22%,52,72.22%,57,79.17%,5,6.94%,0
751,7685.0,15,10,66.67%,10,66.67%,10,66.67%,0,0.00%,0
752,7737.0,131,92,70.23%,76,58.02%,95,72.52%,3,2.29%,16
754,7777.0,56,40,71.43%,39,69.64%,44,78.57%,4,7.14%,1
755,7909.0,129,102,79.07%,99,76.74%,109,84.50%,7,5.43%,3
756,7910.0,106,72,67.92%,72,67.92%,88,83.02%,16,15.09%,0
757,8359.0,95,65,68.42%,64,67.37%,69,72.63%,4,4.21%,1
758,8216.0,41,15,36.59%,15,36.59%,25,60.98%,10,24.39%,0
759,7510.0,128,77,60.16%,77,60.16%,92,71.88%,15,11.72%,0
760,7513.0,173,32,18.50%,31,17.92%,36,20.81%,4,2.31%,1
761,7540.0,135,105,77.78%,105,77.78%,113,83.70%,8,5.93%,0
762,7542.0,114,87,76.32%,87,76.32%,93,81.58%,6,5.26%,0
763,7546.0,43,40,93.02%,40,93.02%,40,93.02%,0,0.00%,0
764,7574.0,105,86,81.90%,86,81.90%,89,84.76%,3,2.86%,0
765,7578.0,127,104,81.89%,97,76.38%,105,82.68%,1,0.79%,7
766,7582.0,78,69,88.46%,68,87.18%,75,96.15%,6,7.69%,1
767,7586.0,94,82,87.23%,81,86.17%,85,90.43%,3,3.19%,1
769,7587.0,104,69,66.35%,69,66.35%,73,70.19%,4,3.85%,0
770,7588.0,87,47,54.02%,47,54.02%,49,56.32%,2,2.30%,0
771,7647.0,153,149,97.39%,149,97.39%,152,99.35%,3,1.96%,0
772,7649.0,138,81,58.70%,81,58.70%,81,58.70%,0,0.00%,0
773,7665.0,177,92,51.98%,83,46.89%,97,54.80%,5,2.82%,9
774,7666.0,268,175,65.30%,175,65.30%,179,66.79%,4,1.49%,0
775,8205.0,474,176,37.13%,175,36.92%,203,42.83%,27,5.70%,1
776,7672.0,138,86,62.32%,86,62.32%,94,68.12%,8,5.80%,0
778,8207.0,217,147,67.74%,145,66.82%,148,68.20%,1,0.46%,2
779,8358.0,110,78,70.91%,78,70.91%,96,87.27%,18,16.36%,0
780,3728.0,2,0,0.00%,0,0.00%,0,0.00%,0,0.00%,0
781,3808.0,116,109,93.97%,109,93.97%,109,93.97%,0,0.00%,0
782,3816.0,187,107,57.22%,98,52.41%,114,60.96%,7,3.74%,9
783,3818.0,144,80,55.56%,78,54.17%,81,56.25%,1,0.69%,2
784,3841.0,125,43,34.40%,34,27.20%,48,38.40%,5,4.00%,9
785,3842.0,127,36,28.35%,28,22.05%,39,30.71%,3,2.36%,8
786,3843.0,223,78,34.98%,78,34.98%,78,34.98%,0,0.00%,0
787,3844.0,135,69,51.11%,60,44.44%,71,52.59%,2,1.48%,9
788,3845.0,308,115,37.34%,107,34.74%,121,39.29%,6,1.95%,8
789,3847.0,142,75,52.82%,61,42.96%,83,58.45%,8,5.63%,14
790,3848.0,537,406,75.61%,405,75.42%,409,76.16%,3,0.56%,1
791,3849.0,167,31,18.56%,23,13.77%,33,19.76%,2,1.20%,8
792,3850.0,183,48,26.23%,39,21.31%,52,28.42%,4,2.19%,9
793,3851.0,59,22,37.29%,21,35.59%,24,40.68%,2,3.39%,1
794,3855.0,748,156,20.86%,151,20.19%,156,20.86%,0,0.00%,5
795,3857.0,93,58,62.37%,50,53.76%,61,65.59%,3,3.23%,8
796,3859.0,89,21,23.60%,19,21.35%,23,25.84%,2,2.25%,2
797,3860.0,96,54,56.25%,49,51.04%,54,56.25%,0,0.00%,5
798,3861.0,111,46,41.44%,45,40.54%,48,43.24%,2,1.80%,1
799,6527.0,258,127,49.22%,119,46.12%,135,52.33%,8,3.10%,8
800,6548.0,68,33,48.53%,29,42.65%,33,48.53%,0,0.00%,4
801,6675.0,95,46,48.42%,40,42.11%,51,53.68%,5,5.26%,6
802,6822.0,192,98,51.04%,95,49.48%,101,52.60%,3,1.56%,3
803,6996.0,168,85,50.60%,84,50.00%,85,50.60%,0,0.00%,1
804,7023.0,186,123,66.13%,122,65.59%,124,66.67%,1,0.54%,1
805,7070.0,139,111,79.86%,110,79.14%,113,81.29%,2,1.44%,1
806,7072.0,133,65,48.87%,59,44.36%,68,51.13%,3,2.26%,6
807,7229.0,77,39,50.65%,39,50.65%,39,50.65%,0,0.00%,0
808,7245.0,75,17,22.67%,17,22.67%,19,25.33%,2,2.67%,0
809,7255.0,42,6,14.29%,6,14.29%,6,14.29%,0,0.00%,0
810,7664.0,64,38,59.38%,38,59.38%,39,60.94%,1,1.56%,0
811,7780.0,69,56,81.16%,51,73.91%,60,86.96%,4,5.80%,5
812,7782.0,115,92,80.00%,86,74.78%,95,82.61%,3,2.61%,6
813,7808.0,50,33,66.00%,31,62.00%,37,74.00%,4,8.00%,2
814,7811.0,103,84,81.55%,81,78.64%,86,83.50%,2,1.94%,3
815,7813.0,65,18,27.69%,18,27.69%,22,33.85%,4,6.15%,0
816,7815.0,93,44,47.31%,43,46.24%,49,52.69%,5,5.38%,1
817,7850.0,35,13,37.14%,11,31.43%,14,40.00%,1,2.86%,2
818,7852.0,104,8,7.69%,7,6.73%,9,8.65%,1,0.96%,1
819,7855.0,112,8,7.14%,7,6.25%,8,7.14%,0,0.00%,1
820,7903.0,95,39,41.05%,38,40.00%,42,44.21%,3,3.16%,1
821,7904.0,188,136,72.34%,134,71.28%,139,73.94%,3,1.60%,2
822,7905.0,96,77,80.21%,76,79.17%,78,81.25%,1,1.04%,1
823,7906.0,119,0,0.00%,0,0.00%,0,0.00%,0,0.00%,0
824,8039.0,136,81,59.56%,77,56.62%,83,61.03%,2,1.47%,4
825,8293.0,80,34,42.50%,31,38.75%,41,51.25%,7,8.75%,3
826,8298.0,133,42,31.58%,31,23.31%,46,34.59%,4,3.01%,11
827,8328.0,50,9,18.00%,8,16.00%,9,18.00%,0,0.00%,1
828,8329.0,41,25,60.98%,24,58.54%,25,60.98%,0,0.00%,1
829,8330.0,116,98,84.48%,94,81.03%,100,86.21%,2,1.72%,4
830,8331.0,36,1,2.78%,1,2.78%,2,5.56%,1,2.78%,0
831,8332.0,56,32,57.14%,31,55.36%,35,62.50%,3,5.36%,1
832,8385.0,7,0,0.00%,0,0.00%,0,0.00%,0,0.00%,0
833,8386.0,19,4,21.05%,3,15.79%,4,21.05%,0,0.00%,1
834,8388.0,103,35,33.98%,33,32.04%,40,38.83%,5,4.85%,2
836,8195.0,105,66,62.86%,66,62.86%,70,66.67%,4,3.81%,0
837,7961.0,94,71,75.53%,71,75.53%,78,82.98%,7,7.45%,0
838,8148.0,47,26,55.32%,23,48.94%,27,57.45%,1,2.13%,3
839,7981.0,78,65,83.33%,64,82.05%,68,87.18%,3,3.85%,1
840,8126.0,94,68,72.34%,68,72.34%,73,77.66%,5,5.32%,0
841,4310.0,249,127,51.00%,126,50.60%,133,53.41%,6,2.41%,1
843,5261.0,371,255,68.73%,255,68.73%,262,70.62%,7,1.89%,0
845,6222.0,11,6,54.55%,6,54.55%,6,54.55%,0,0.00%,0
846,3869.0,56,31,55.36%,31,55.36%,35,62.50%,4,7.14%,0
847,6223.0,16,9,56.25%,9,56.25%,11,68.75%,2,12.50%,0
848,3875.0,37,16,43.24%,16,43.24%,17,45.95%,1,2.70%,0
849,3877.0,23,11,47.83%,11,47.83%,12,52.17%,1,4.35%,0
850,3891.0,192,124,64.58%,116,60.42%,133,69.27%,9,4.69%,8
851,8403.0,65,39,60.00%,38,58.46%,41,63.08%,2,3.08%,1
853,6583.0,72,44,61.11%,42,58.33%,45,62.50%,1,1.39%,2
854,8161.0,11,10,90.91%,7,63.64%,10,90.91%,0,0.00%,3
855,3883.0,136,72,52.94%,72,52.94%,74,54.41%,2,1.47%,0
856,3910.0,111,53,47.75%,51,45.95%,53,47.75%,0,0.00%,2
857,3924.0,250,136,54.40%,126,50.40%,138,55.20%,2,0.80%,10
859,3940.0,74,38,51.35%,38,51.35%,45,60.81%,7,9.46%,0
860,5264.0,95,40,42.11%,39,41.05%,42,44.21%,2,2.11%,1
862,5070.0,167,150,89.82%,143,85.63%,151,90.42%,1,0.60%,7
863,3957.0,51,30,58.82%,27,52.94%,30,58.82%,0,0.00%,3
864,3914.0,49,34,69.39%,31,63.27%,35,71.43%,1,2.04%,3
866,3962.0,153,77,50.33%,76,49.67%,77,50.33%,0,0.00%,1
868,3969.0,193,121,62.69%,113,58.55%,125,64.77%,4,2.07%,8
870,6207.0,41,18,43.90%,16,39.02%,19,46.34%,1,2.44%,2
871,3978.0,65,44,67.69%,41,63.08%,45,69.23%,1,1.54%,3
873,3994.0,70,43,61.43%,39,55.71%,43,61.43%,0,0.00%,4
875,3988.0,71,41,57.75%,39,54.93%,42,59.15%,1,1.41%,2
877,6210.0,38,25,65.79%,24,63.16%,25,65.79%,0,0.00%,1
878,4002.0,20,10,50.00%,10,50.00%,10,50.00%,0,0.00%,0
879,4006.0,22,13,59.09%,11,50.00%,14,63.64%,1,4.55%,2
880,6800.0,28,13,46.43%,12,42.86%,14,50.00%,1,3.57%,1
881,8274.0,157,72,45.86%,67,42.68%,77,49.04%,5,3.18%,5
882,6216.0,24,8,33.33%,7,29.17%,9,37.50%,1,4.17%,1
883,4026.0,88,52,59.09%,48,54.55%,57,64.77%,5,5.68%,4
885,4030.0,35,21,60.00%,21,60.00%,21,60.00%,0,0.00%,0
886,4034.0,67,44,65.67%,40,59.70%,44,65.67%,0,0.00%,4
887,6418.0,75,37,49.33%,36,48.00%,38,50.67%,1,1.33%,1
888,6419.0,44,22,50.00%,22,50.00%,24,54.55%,2,4.55%,0
890,4044.0,83,50,60.24%,47,56.63%,52,62.65%,2,2.41%,3
891,4049.0,77,49,63.64%,49,63.64%,51,66.23%,2,2.60%,0
892,4054.0,57,31,54.39%,30,52.63%,33,57.89%,2,3.51%,1
894,4058.0,62,27,43.55%,27,43.55%,32,51.61%,5,8.06%,0
895,6373.0,70,36,51.43%,35,50.00%,39,55.71%,3,4.29%,1
896,4064.0,47,19,40.43%,16,34.04%,20,42.55%,1,2.13%,3
897,4068.0,102,49,48.04%,49,48.04%,54,52.94%,5,4.90%,0
898,4080.0,111,65,58.56%,63,56.76%,66,59.46%,1,0.90%,2
899,4085.0,125,101,80.80%,100,80.00%,101,80.80%,0,0.00%,1
901,4091.0,172,83,48.26%,79,45.93%,83,48.26%,0,0.00%,4
902,4098.0,87,46,52.87%,42,48.28%,49,56.32%,3,3.45%,4
903,4106.0,140,56,40.00%,55,39.29%,67,47.86%,11,7.86%,1
905,4931.0,140,61,43.57%,60,42.86%,66,47.14%,5,3.57%,1
907,1668.0,126,57,45.24%,53,42.06%,70,55.56%,13,10.32%,4
908,4126.0,62,34,54.84%,23,37.10%,35,56.45%,1,1.61%,11
909,7833.0,25,13,52.00%,13,52.00%,14,56.00%,1,4.00%,0
910,4135.0,48,20,41.67%,15,31.25%,21,43.75%,1,2.08%,5
911,4143.0,69,29,42.03%,27,39.13%,30,43.48%,1,1.45%,2
912,4146.0,48,26,54.17%,26,54.17%,29,60.42%,3,6.25%,0
913,4149.0,169,98,57.99%,94,55.62%,106,62.72%,8,4.73%,4
914,4165.0,33,22,66.67%,16,48.48%,25,75.76%,3,9.09%,6
915,4188.0,86,56,65.12%,56,65.12%,60,69.77%,4,4.65%,0
916,4181.0,114,40,35.09%,36,31.58%,41,35.96%,1,0.88%,4
918,4195.0,76,49,64.47%,49,64.47%,49,64.47%,0,0.00%,0
920,4203.0,74,45,60.81%,38,51.35%,46,62.16%,1,1.35%,7
921,4217.0,363,282,77.69%,256,70.52%,286,78.79%,4,1.10%,26
923,4715.0,106,68,64.15%,62,58.49%,68,64.15%,0,0.00%,6
925,4235.0,81,54,66.67%,53,65.43%,57,70.37%,3,3.70%,1
926,4242.0,83,47,56.63%,47,56.63%,47,56.63%,0,0.00%,0
928,4249.0,101,64,63.37%,60,59.41%,65,64.36%,1,0.99%,4
930,5083.0,333,307,92.19%,296,88.89%,307,92.19%,0,0.00%,11
931,7019.0,215,77,35.81%,74,34.42%,78,36.28%,1,0.47%,3
933,6012.0,226,146,64.60%,138,61.06%,151,66.81%,5,2.21%,8
935,4286.0,124,42,33.87%,42,33.87%,42,33.87%,0,0.00%,0
937,4295.0,208,120,57.69%,120,57.69%,122,58.65%,2,0.96%,0
939,6704.0,160,91,56.88%,86,53.75%,92,57.50%,1,0.63%,5
940,4930.0,174,121,69.54%,118,67.82%,127,72.99%,6,3.45%,3
941,4340.0,146,107,73.29%,106,72.60%,112,76.71%,5,3.42%,1
943,4352.0,135,86,63.70%,80,59.26%,89,65.93%,3,2.22%,6
945,4360.0,283,226,79.86%,225,79.51%,227,80.21%,1,0.35%,1
947,7550.0,34,9,26.47%,9,26.47%,9,26.47%,0,0.00%,0
948,4845.0,305,232,76.07%,232,76.07%,236,77.38%,4,1.31%,0
950,4373.0,156,121,77.56%,120,76.92%,121,77.56%,0,0.00%,1
952,4404.0,451,308,68.29%,304,67.41%,313,69.40%,5,1.11%,4
954,8421.0,67,45,67.16%,43,64.18%,45,67.16%,0,0.00%,2
956,4431.0,257,176,68.48%,169,65.76%,179,69.65%,3,1.17%,7
957,4442.0,144,104,72.22%,104,72.22%,112,77.78%,8,5.56%,0
959,6181.0,53,33,62.26%,24,45.28%,34,64.15%,1,1.89%,9
960,4458.0,142,0,0.00%,0,0.00%,0,0.00%,0,0.00%,0
962,8323.0,91,50,54.95%,46,50.55%,52,57.14%,2,2.20%,4
964,4717.0,390,308,78.97%,300,76.92%,311,79.74%,3,0.77%,8
966,6648.0,304,243,79.93%,242,79.61%,246,80.92%,3,0.99%,1
968,6191.0,122,49,40.16%,45,36.89%,52,42.62%,3,2.46%,4
969,4735.0,173,92,53.18%,92,53.18%,95,54.91%,3,1.73%,0
971,5271.0,169,107,63.31%,100,59.17%,109,64.50%,2,1.18%,7
973,4528.0,84,52,61.90%,51,60.71%,55,65.48%,3,3.57%,1
974,4545.0,472,342,72.46%,330,69.92%,351,74.36%,9,1.91%,12
976,4553.0,437,329,75.29%,321,73.46%,331,75.74%,2,0.46%,8
978,4558.0,228,130,57.02%,129,56.58%,137,60.09%,7,3.07%,1
980,4564.0,166,93,56.02%,89,53.61%,108,65.06%,15,9.04%,4
982,4571.0,116,60,51.72%,60,51.72%,60,51.72%,0,0.00%,0
984,7624.0,67,0,0.00%,0,0.00%,0,0.00%,0,0.00%,0
985,4577.0,258,168,65.12%,161,62.40%,177,68.60%,9,3.49%,7
987,4598.0,361,216,59.83%,194,53.74%,220,60.94%,4,1.11%,22
989,4602.0,214,145,67.76%,138,64.49%,145,67.76%,0,0.00%,7
991,4608.0,287,167,58.19%,164,57.14%,180,62.72%,13,4.53%,3
993,4614.0,218,177,81.19%,170,77.98%,177,81.19%,0,0.00%,7
995,4623.0,298,182,61.07%,172,57.72%,191,64.09%,9,3.02%,10
997,6705.0,219,140,63.93%,134,61.19%,148,67.58%,8,3.65%,6
999,4647.0,244,67,27.46%,67,27.46%,69,28.28%,2,0.82%,0
1001,5168.0,385,89,23.12%,88,22.86%,93,24.16%,4,1.04%,1
1002,4658.0,216,179,82.87%,179,82.87%,180,83.33%,1,0.46%,0
1004,1732.0,273,195,71.43%,185,67.77%,198,72.53%,3,1.10%,10
1005,4704.0,266,178,66.92%,173,65.04%,181,68.05%,3,1.13%,5
1007,6345.0,228,141,61.84%,133,58.33%,147,64.47%,6,2.63%,8
1009,,"125,228","77,250",61.69%,"75,022",59.91%,"79,658",63.61%,"2,408",1.92%,"2,228"
1010,,,- 2 -,,,,,www.pimsreports.pa.gov,,,
