,school number,graduate count,college bound,total college bound %,2- or 4-year college or university,total postsecondary bound,total postsecondary bound %,non-degree-granting postsecondary school,non-degree-granting postsecondary school %,specialized associate degree granting institution
0,7691.0,71,50,70.4%,50,62,87.3%,12,16.9%,0
1,3241.0,580,516,89.0%,508,521,89.8%,5,0.9%,8
2,5091.0,315,270,85.7%,259,276,87.6%,6,1.9%,11
3,7846.0,33,4,12.1%,1,6,18.2%,2,6.1%,3
4,7824.0,81,19,23.5%,15,23,28.4%,4,4.9%,4
5,7858.0,30,10,33.3%,9,10,33.3%,0,0.0%,1
6,6001.0,243,128,52.7%,111,148,60.9%,20,8.2%,17
7,6554.0,89,55,61.8%,47,61,68.5%,6,6.7%,8
8,29.0,98,85,86.7%,82,89,90.8%,4,4.1%,3
9,4664.0,86,39,45.3%,34,48,55.8%,9,10.5%,5
10,2795.0,387,260,67.2%,254,265,68.5%,5,1.3%,6
11,2794.0,693,399,57.6%,395,408,58.9%,9,1.3%,4
12,913.0,512,322,62.9%,299,343,67.0%,21,4.1%,23
13,7425.0,5,0,0.0%,0,0,0.0%,0,0.0%,0
14,6555.0,190,148,77.9%,137,152,80.0%,4,2.1%,11
15,2725.0,108,77,71.3%,77,82,75.9%,5,4.6%,0
16,820.0,98,70,71.4%,69,76,77.6%,6,6.1%,1
17,2320.0,91,68,74.7%,62,71,78.0%,3,3.3%,6
18,7578.0,131,0,0.0%,0,0,0.0%,0,0.0%,0
19,582.0,48,37,77.1%,30,37,77.1%,0,0.0%,7
20,6575.0,98,81,82.7%,74,83,84.7%,2,2.0%,7
21,596.0,132,104,78.8%,104,105,79.5%,1,0.8%,0
22,7640.0,73,50,68.5%,47,53,72.6%,3,4.1%,3
23,958.0,205,123,60.0%,119,127,62.0%,4,2.0%,4
24,6222.0,18,8,44.4%,8,9,50.0%,1,5.6%,0
25,4165.0,62,39,62.9%,39,47,75.8%,8,12.9%,0
26,7721.0,33,25,75.8%,25,25,75.8%,0,0.0%,0
27,1367.0,421,328,77.9%,328,345,81.9%,17,4.0%,0
28,5199.0,91,79,86.8%,74,79,86.8%,0,0.0%,5
29,1335.0,162,98,60.5%,87,99,61.1%,1,0.6%,11
30,50.0,400,332,83.0%,309,347,86.8%,15,3.8%,23
31,3434.0,309,193,62.5%,190,194,62.8%,1,0.3%,3
32,7847.0,9,0,0.0%,0,0,0.0%,0,0.0%,0
33,640.0,165,128,77.6%,128,134,81.2%,6,3.6%,0
34,726.0,128,67,52.3%,66,72,56.3%,5,3.9%,1
35,742.0,30,17,56.7%,17,19,63.3%,2,6.7%,0
36,4930.0,239,182,76.2%,168,184,77.0%,2,0.8%,14
37,1343.0,255,194,76.1%,174,195,76.5%,1,0.4%,20
38,917.0,102,67,65.7%,67,75,73.5%,8,7.8%,0
39,5116.0,466,346,74.2%,334,371,79.6%,25,5.4%,12
40,1595.0,54,35,64.8%,34,37,68.5%,2,3.7%,1
41,4188.0,92,79,85.9%,60,80,87.0%,1,1.1%,19
42,6207.0,82,60,73.2%,56,60,73.2%,0,0.0%,4
43,3.0,154,99,64.3%,76,101,65.6%,2,1.3%,23
44,1605.0,208,148,71.2%,144,150,72.1%,2,1.0%,4
45,62.0,460,453,98.5%,442,454,98.7%,1,0.2%,11
46,4957.0,468,407,87.0%,389,409,87.4%,2,0.4%,18
47,3465.0,655,552,84.3%,535,553,84.4%,1,0.2%,17
48,4181.0,95,63,66.3%,49,65,68.4%,2,2.1%,14
49,649.0,147,112,76.2%,93,114,77.6%,2,1.4%,19
50,1677.0,208,123,59.1%,120,136,65.4%,13,6.3%,3
51,6707.0,223,157,70.4%,157,176,78.9%,19,8.5%,0
52,5135.0,46,32,69.6%,28,35,76.1%,3,6.5%,4
53,4706.0,95,70,73.7%,60,73,76.8%,3,3.2%,10
54,2353.0,82,61,74.4%,52,64,78.0%,3,3.7%,9
55,1612.0,99,76,76.8%,73,78,78.8%,2,2.0%,3
56,3891.0,226,171,75.7%,163,183,81.0%,12,5.3%,8
57,4034.0,76,55,72.4%,52,55,72.4%,0,0.0%,3
58,6306.0,556,400,71.9%,378,412,74.1%,12,2.2%,22
59,4691.0,253,189,74.7%,181,199,78.7%,10,4.0%,8
60,6308.0,140,109,77.9%,107,110,78.6%,1,0.7%,2
61,70.0,103,81,78.6%,81,86,83.5%,5,4.9%,0
62,1014.0,99,67,67.7%,62,69,69.7%,2,2.0%,5
63,1029.0,352,268,76.1%,260,280,79.5%,12,3.4%,8
64,2362.0,67,48,71.6%,39,54,80.6%,6,9.0%,9
65,6162.0,140,85,60.7%,82,96,68.6%,11,7.9%,3
66,4818.0,106,56,52.8%,48,56,52.8%,0,0.0%,8
67,1030.0,312,199,63.8%,195,199,63.8%,0,0.0%,4
68,4195.0,116,84,72.4%,66,93,80.2%,9,7.8%,18
69,4340.0,165,141,85.5%,132,144,87.3%,3,1.8%,9
70,1147.0,610,505,82.8%,490,522,85.6%,17,2.8%,15
71,4203.0,76,63,82.9%,58,72,94.7%,9,11.8%,5
72,5212.0,110,81,73.6%,76,81,73.6%,0,0.0%,5
73,1299.0,83,52,62.7%,48,54,65.1%,2,2.4%,4
74,1682.0,85,74,87.1%,70,74,87.1%,0,0.0%,4
75,4217.0,329,282,85.7%,267,288,87.5%,6,1.8%,15
76,988.0,85,47,55.3%,46,50,58.8%,3,3.5%,1
77,4870.0,64,24,37.5%,22,24,37.5%,0,0.0%,2
78,2420.0,101,61,60.4%,54,65,64.4%,4,4.0%,7
79,7577.0,62,16,25.8%,14,17,27.4%,1,1.6%,2
80,1694.0,347,234,67.4%,234,244,70.3%,10,2.9%,0
81,79.0,103,78,75.7%,69,78,75.7%,0,0.0%,9
82,7112.0,74,43,58.1%,36,45,60.8%,2,2.7%,7
83,2798.0,106,77,72.6%,71,79,74.5%,2,1.9%,6
84,1040.0,468,392,83.8%,392,409,87.4%,17,3.6%,0
85,654.0,142,113,79.6%,107,114,80.3%,1,0.7%,6
86,7293.0,177,0,0.0%,0,0,0.0%,0,0.0%,0
87,7726.0,16,12,75.0%,12,15,93.8%,3,18.8%,0
88,5133.0,482,445,92.3%,442,447,92.7%,2,0.4%,3
89,7790.0,582,511,87.8%,509,530,91.1%,19,3.3%,2
90,1043.0,476,371,77.9%,371,374,78.6%,3,0.6%,0
91,1208.0,158,109,69.0%,102,113,71.5%,4,2.5%,7
92,1619.0,174,107,61.5%,107,122,70.1%,15,8.6%,0
93,1746.0,304,243,79.9%,243,243,79.9%,0,0.0%,0
94,1745.0,475,409,86.1%,399,417,87.8%,8,1.7%,10
95,6252.0,65,41,63.1%,41,42,64.6%,1,1.5%,0
96,5118.0,156,93,59.6%,84,97,62.2%,4,2.6%,9
97,7720.0,16,9,56.3%,4,10,62.5%,1,6.3%,5
98,4545.0,349,273,78.2%,258,281,80.5%,8,2.3%,15
99,2191.0,601,319,53.1%,310,337,56.1%,18,3.0%,9
100,4715.0,101,87,86.1%,67,88,87.1%,1,1.0%,20
101,6706.0,293,251,85.7%,248,252,86.0%,1,0.3%,3
102,4235.0,102,79,77.5%,66,81,79.4%,2,2.0%,13
103,3260.0,395,375,94.9%,373,375,94.9%,0,0.0%,2
104,6492.0,241,132,54.8%,96,132,54.8%,0,0.0%,36
105,732.0,155,102,65.8%,85,104,67.1%,2,1.3%,17
106,1849.0,255,153,60.0%,151,186,72.9%,33,12.9%,2
107,7727.0,94,76,80.9%,70,76,80.9%,0,0.0%,6
108,7156.0,56,48,85.7%,48,49,87.5%,1,1.8%,0
109,1475.0,72,53,73.6%,49,53,73.6%,0,0.0%,4
110,1480.0,71,48,67.6%,46,49,69.0%,1,1.4%,2
111,921.0,62,41,66.1%,26,42,67.7%,1,1.6%,15
112,6236.0,201,117,58.2%,95,125,62.2%,8,4.0%,22
113,5012.0,509,352,69.2%,346,418,82.1%,66,13.0%,6
114,6290.0,263,176,66.9%,167,177,67.3%,1,0.4%,9
115,7628.0,10,9,90.0%,7,9,90.0%,0,0.0%,2
116,3333.0,356,314,88.2%,308,321,90.2%,7,2.0%,6
117,2515.0,110,61,55.5%,50,71,64.5%,10,9.1%,11
118,5178.0,150,63,42.0%,62,67,44.7%,4,2.7%,1
119,6122.0,62,47,75.8%,39,49,79.0%,2,3.2%,8
120,7510.0,132,64,48.5%,64,75,56.8%,11,8.3%,0
121,3978.0,96,75,78.1%,67,78,81.3%,3,3.1%,8
122,5136.0,64,42,65.6%,41,43,67.2%,1,1.6%,1
123,2532.0,249,175,70.3%,164,192,77.1%,17,6.8%,11
124,17.0,297,191,64.3%,179,209,70.4%,18,6.1%,12
125,1637.0,91,56,61.5%,49,57,62.6%,1,1.1%,7
126,1639.0,64,39,60.9%,30,40,62.5%,1,1.6%,9
127,1644.0,62,35,56.5%,30,36,58.1%,1,1.6%,5
128,6643.0,83,19,22.9%,18,26,31.3%,7,8.4%,1
129,5228.0,238,171,71.8%,171,183,76.9%,12,5.0%,0
130,777.0,242,186,76.9%,179,195,80.6%,9,3.7%,7
131,6946.0,60,46,76.7%,46,46,76.7%,0,0.0%,0
132,4800.0,428,312,72.9%,312,317,74.1%,5,1.2%,0
133,1998.0,186,113,60.8%,91,123,66.1%,10,5.4%,22
134,3869.0,66,47,71.2%,47,51,77.3%,4,6.1%,0
135,5096.0,589,0,0.0%,0,0,0.0%,0,0.0%,0
136,7749.0,508,474,93.3%,473,476,93.7%,2,0.4%,1
137,4098.0,98,70,71.4%,54,70,71.4%,0,0.0%,16
138,1632.0,72,47,65.3%,46,47,65.3%,0,0.0%,1
139,1654.0,233,146,62.7%,144,158,67.8%,12,5.2%,2
140,2860.0,279,234,83.9%,233,242,86.7%,8,2.9%,1
141,7624.0,46,3,6.5%,3,3,6.5%,0,0.0%,0
142,1701.0,570,449,78.8%,449,449,78.8%,0,0.0%,0
143,1529.0,74,55,74.3%,51,59,79.7%,4,5.4%,4
144,2869.0,218,191,87.6%,189,194,89.0%,3,1.4%,2
145,4553.0,435,328,75.4%,316,343,78.9%,15,3.4%,12
146,4810.0,249,173,69.5%,158,174,69.9%,1,0.4%,15
147,3425.0,191,154,80.6%,152,155,81.2%,1,0.5%,2
148,5278.0,178,71,39.9%,58,75,42.1%,4,2.2%,13
149,513.0,159,120,75.5%,120,138,86.8%,18,11.3%,0
150,7671.0,140,80,57.1%,79,99,70.7%,19,13.6%,1
151,5261.0,446,374,83.9%,366,377,84.5%,3,0.7%,8
152,4352.0,210,176,83.8%,163,183,87.1%,7,3.3%,13
153,4801.0,264,225,85.2%,225,233,88.3%,8,3.0%,0
154,2539.0,208,124,59.6%,114,128,61.5%,4,1.9%,10
155,4558.0,207,138,66.7%,118,150,72.5%,12,5.8%,20
156,7759.0,439,413,94.1%,412,418,95.2%,5,1.1%,1
157,1387.0,471,415,88.1%,412,415,88.1%,0,0.0%,3
158,7550.0,25,10,40.0%,6,10,40.0%,0,0.0%,4
159,6156.0,301,227,75.4%,197,239,79.4%,12,4.0%,30
160,2429.0,148,135,91.2%,128,135,91.2%,0,0.0%,7
161,5193.0,124,105,84.7%,94,108,87.1%,3,2.4%,11
162,6364.0,153,111,72.5%,104,119,77.8%,8,5.2%,7
163,2809.0,637,524,82.3%,523,534,83.8%,10,1.6%,1
164,1707.0,193,168,87.0%,168,169,87.6%,1,0.5%,0
165,7641.0,321,76,23.7%,76,77,24.0%,1,0.3%,0
166,6935.0,380,271,71.3%,262,278,73.2%,7,1.8%,9
167,2554.0,309,186,60.2%,180,188,60.8%,2,0.6%,6
168,2740.0,180,111,61.7%,102,118,65.6%,7,3.9%,9
169,4564.0,175,110,62.9%,97,119,68.0%,9,5.1%,13
170,3482.0,698,588,84.2%,582,607,87.0%,19,2.7%,6
171,144.0,195,154,79.0%,137,158,81.0%,4,2.1%,17
172,2562.0,281,196,69.8%,191,203,72.2%,7,2.5%,5
173,6418.0,101,73,72.3%,71,75,74.3%,2,2.0%,2
174,2675.0,130,91,70.0%,86,95,73.1%,4,3.1%,5
175,6293.0,363,212,58.4%,202,234,64.5%,22,6.1%,10
176,7842.0,19,1,5.3%,1,2,10.5%,1,5.3%,0
177,7294.0,162,94,58.0%,63,101,62.3%,7,4.3%,31
178,2026.0,212,146,68.9%,146,147,69.3%,1,0.5%,0
179,7515.0,231,226,97.8%,226,226,97.8%,0,0.0%,0
180,2027.0,159,90,56.6%,80,97,61.0%,7,4.4%,10
181,7897.0,125,73,58.4%,72,79,63.2%,6,4.8%,1
182,7866.0,9,8,88.9%,8,8,88.9%,0,0.0%,0
183,788.0,317,0,0.0%,0,0,0.0%,0,0.0%,0
184,6269.0,96,63,65.6%,61,65,67.7%,2,2.1%,2
185,6737.0,134,114,85.1%,107,114,85.1%,0,0.0%,7
186,2201.0,45,16,35.6%,15,18,40.0%,2,4.4%,1
187,5248.0,68,3,4.4%,3,3,4.4%,0,0.0%,0
188,1225.0,56,31,55.4%,29,34,60.7%,3,5.4%,2
189,5023.0,218,147,67.4%,141,153,70.2%,6,2.8%,6
190,2246.0,33,19,57.6%,18,19,57.6%,0,0.0%,1
191,6159.0,22,15,68.2%,12,15,68.2%,0,0.0%,3
192,6161.0,46,32,69.6%,21,33,71.7%,1,2.2%,11
193,6419.0,67,39,58.2%,39,40,59.7%,1,1.5%,0
194,1191.0,230,154,67.0%,143,163,70.9%,9,3.9%,11
195,4242.0,90,65,72.2%,61,65,72.2%,0,0.0%,4
196,2037.0,196,133,67.9%,130,147,75.0%,14,7.1%,3
197,156.0,371,335,90.3%,322,340,91.6%,5,1.3%,13
198,4106.0,179,102,57.0%,100,109,60.9%,7,3.9%,2
199,4360.0,320,280,87.5%,270,282,88.1%,2,0.6%,10
200,7666.0,179,138,77.1%,123,149,83.2%,11,6.1%,15
201,2126.0,81,51,63.0%,44,54,66.7%,3,3.7%,7
202,6563.0,131,104,79.4%,91,107,81.7%,3,2.3%,13
203,594.0,134,103,76.9%,98,113,84.3%,10,7.5%,5
204,7586.0,74,65,87.8%,65,68,91.9%,3,4.1%,0
205,6223.0,22,10,45.5%,10,10,45.5%,0,0.0%,0
206,1869.0,355,323,91.0%,314,333,93.8%,10,2.8%,9
207,170.0,339,275,81.1%,268,284,83.8%,9,2.7%,7
208,2040.0,210,165,78.6%,160,170,81.0%,5,2.4%,5
209,6271.0,285,200,70.2%,177,203,71.2%,3,1.1%,23
210,2043.0,138,96,69.6%,79,99,71.7%,3,2.2%,17
211,5219.0,71,43,60.6%,43,53,74.6%,10,14.1%,0
212,802.0,311,236,75.9%,236,261,83.9%,25,8.0%,0
213,1424.0,318,292,91.8%,292,294,92.5%,2,0.6%,0
214,1251.0,212,114,53.8%,113,114,53.8%,0,0.0%,1
215,4845.0,317,265,83.6%,261,269,84.9%,4,1.3%,4
216,5242.0,190,136,71.6%,135,138,72.6%,2,1.1%,1
217,2206.0,204,135,66.2%,126,144,70.6%,9,4.4%,9
218,4373.0,224,138,61.6%,131,138,61.6%,0,0.0%,7
219,3137.0,106,69,65.1%,62,72,67.9%,3,2.8%,7
220,6341.0,68,29,42.6%,28,33,48.5%,4,5.9%,1
221,6125.0,46,30,65.2%,27,34,73.9%,4,8.7%,3
222,3145.0,159,126,79.2%,117,132,83.0%,6,3.8%,9
223,6330.0,78,54,69.2%,52,56,71.8%,2,2.6%,2
224,808.0,195,114,58.5%,113,138,70.8%,24,12.3%,1
225,5190.0,253,230,90.9%,230,235,92.9%,5,2.0%,0
226,2891.0,166,106,63.9%,104,108,65.1%,2,1.2%,2
227,4571.0,104,66,63.5%,55,68,65.4%,2,1.9%,11
228,7948.0,154,110,71.4%,109,115,74.7%,5,3.2%,1
229,1547.0,28,16,57.1%,12,16,57.1%,0,0.0%,4
230,7899.0,66,9,13.6%,9,9,13.6%,0,0.0%,0
231,7900.0,64,43,67.2%,37,45,70.3%,2,3.1%,6
232,6333.0,248,169,68.1%,157,173,69.8%,4,1.6%,12
233,7902.0,57,53,93.0%,53,55,96.5%,2,3.5%,0
234,1761.0,3,0,0.0%,0,0,0.0%,0,0.0%,0
235,3272.0,473,425,89.9%,415,431,91.1%,6,1.3%,10
236,1879.0,461,433,93.9%,418,434,94.1%,1,0.2%,15
237,7348.0,746,505,67.7%,486,514,68.9%,9,1.2%,19
238,2578.0,522,397,76.1%,397,412,78.9%,15,2.9%,0
239,7747.0,3,1,33.3%,1,1,33.3%,0,0.0%,0
240,4404.0,500,418,83.6%,411,429,85.8%,11,2.2%,7
241,3150.0,190,152,80.0%,142,154,81.1%,2,1.1%,10
242,5153.0,203,138,68.0%,110,139,68.5%,1,0.5%,28
243,927.0,1,0,0.0%,0,0,0.0%,0,0.0%,0
244,5207.0,285,199,69.8%,199,216,75.8%,17,6.0%,0
245,2331.0,93,66,71.0%,66,72,77.4%,6,6.5%,0
246,7723.0,68,48,70.6%,44,49,72.1%,1,1.5%,4
247,675.0,227,162,71.4%,150,164,72.2%,2,0.9%,12
248,2305.0,179,111,62.0%,103,118,65.9%,7,3.9%,8
249,7542.0,104,102,98.1%,102,104,100.0%,2,1.9%,0
250,2325.0,290,226,77.9%,213,232,80.0%,6,2.1%,13
251,1885.0,350,245,70.0%,244,254,72.6%,9,2.6%,1
252,4817.0,105,74,70.5%,59,79,75.2%,5,4.8%,15
253,6126.0,58,35,60.3%,22,36,62.1%,1,1.7%,13
254,4412.0,91,70,76.9%,65,70,76.9%,0,0.0%,5
255,5180.0,79,2,2.5%,2,8,10.1%,6,7.6%,0
256,2280.0,68,47,69.1%,44,48,70.6%,1,1.5%,3
257,3277.0,42,40,95.2%,39,40,95.2%,0,0.0%,1
258,3034.0,227,164,72.2%,153,167,73.6%,3,1.3%,11
259,1307.0,151,126,83.4%,118,132,87.4%,6,4.0%,8
260,6218.0,56,43,76.8%,43,43,76.8%,0,0.0%,0
261,2394.0,97,67,69.1%,60,67,69.1%,0,0.0%,7
262,6255.0,135,82,60.7%,55,84,62.2%,2,1.5%,27
263,2308.0,64,32,50.0%,32,36,56.3%,4,6.3%,0
264,5245.0,100,69,69.0%,63,71,71.0%,2,2.0%,6
265,1154.0,113,83,73.5%,77,86,76.1%,3,2.7%,6
266,6482.0,299,232,77.6%,231,238,79.6%,6,2.0%,1
267,1486.0,114,77,67.5%,75,81,71.1%,4,3.5%,2
268,6241.0,29,18,62.1%,14,19,65.5%,1,3.4%,4
269,7589.0,321,208,64.8%,187,219,68.2%,11,3.4%,21
270,7506.0,75,9,12.0%,9,21,28.0%,12,16.0%,0
271,5112.0,201,163,81.1%,153,172,85.6%,9,4.5%,10
272,4431.0,325,283,87.1%,253,285,87.7%,2,0.6%,30
273,816.0,143,98,68.5%,96,100,69.9%,2,1.4%,2
274,7538.0,10,2,20.0%,2,2,20.0%,0,0.0%,0
275,4528.0,95,67,70.5%,62,67,70.5%,0,0.0%,5
276,6404.0,114,79,69.3%,79,88,77.2%,9,7.9%,0
277,2924.0,155,125,80.6%,123,129,83.2%,4,2.6%,2
278,3155.0,126,79,62.7%,63,82,65.1%,3,2.4%,16
279,2607.0,254,188,74.0%,166,192,75.6%,4,1.6%,22
280,7394.0,38,10,26.3%,10,12,31.6%,2,5.3%,0
281,7403.0,14,0,0.0%,0,0,0.0%,0,0.0%,0
282,2596.0,513,343,66.9%,279,354,69.0%,11,2.1%,64
283,7922.0,63,28,44.4%,17,35,55.6%,7,11.1%,11
284,2680.0,90,68,75.6%,63,69,76.7%,1,1.1%,5
285,6600.0,240,197,82.1%,160,205,85.4%,8,3.3%,37
286,4940.0,87,41,47.1%,36,51,58.6%,10,11.5%,5
287,5155.0,191,131,68.6%,103,138,72.3%,7,3.7%,28
288,7923.0,42,37,88.1%,31,39,92.9%,2,4.8%,6
289,7634.0,97,85,87.6%,85,87,89.7%,2,2.1%,0
290,1315.0,224,182,81.3%,175,183,81.7%,1,0.4%,7
291,4807.0,199,87,43.7%,81,98,49.2%,11,5.5%,6
292,4085.0,166,134,80.7%,134,134,80.7%,0,0.0%,0
293,4437.0,53,33,62.3%,31,34,64.2%,1,1.9%,2
294,4442.0,112,92,82.1%,85,93,83.0%,1,0.9%,7
295,7859.0,60,52,86.7%,51,56,93.3%,4,6.7%,1
296,3532.0,82,54,65.9%,47,62,75.6%,8,9.8%,7
297,14.0,120,88,73.3%,79,88,73.3%,0,0.0%,9
298,1776.0,290,228,78.6%,210,234,80.7%,6,2.1%,18
299,7844.0,3,1,33.3%,1,1,33.3%,0,0.0%,0
300,3296.0,220,208,94.5%,204,212,96.4%,4,1.8%,4
301,3295.0,383,365,95.3%,363,369,96.3%,4,1.0%,2
302,4960.0,190,186,97.9%,183,188,98.9%,2,1.1%,3
303,4828.0,102,90,88.2%,90,91,89.2%,1,1.0%,0
304,7012.0,88,56,63.6%,51,71,80.7%,15,17.0%,5
305,2618.0,179,96,53.6%,95,96,53.6%,0,0.0%,1
306,2623.0,413,347,84.0%,345,360,87.2%,13,3.1%,2
307,7672.0,80,72,90.0%,65,72,90.0%,0,0.0%,7
308,2339.0,116,85,73.3%,71,89,76.7%,4,3.4%,14
309,7777.0,35,30,85.7%,30,30,85.7%,0,0.0%,0
310,1902.0,297,253,85.2%,253,265,89.2%,12,4.0%,0
311,1159.0,255,243,95.3%,236,243,95.3%,0,0.0%,7
312,7678.0,77,73,94.8%,73,75,97.4%,2,2.6%,0
313,7582.0,60,55,91.7%,53,60,100.0%,5,8.3%,2
314,7574.0,85,78,91.8%,76,83,97.6%,5,5.9%,2
315,4249.0,158,102,64.6%,93,104,65.8%,2,1.3%,9
316,6105.0,323,242,74.9%,208,251,77.7%,9,2.8%,34
317,5098.0,247,215,87.0%,214,216,87.4%,1,0.4%,1
318,3158.0,97,56,57.7%,56,63,64.9%,7,7.2%,0
319,3305.0,437,381,87.2%,379,388,88.8%,7,1.6%,2
320,3994.0,81,52,64.2%,45,53,65.4%,1,1.2%,7
321,7890.0,118,0,0.0%,0,0,0.0%,0,0.0%,0
322,1790.0,143,86,60.1%,81,86,60.1%,0,0.0%,5
323,3962.0,164,78,47.6%,67,81,49.4%,3,1.8%,11
324,7170.0,243,143,58.8%,120,148,60.9%,5,2.1%,23
325,6887.0,194,120,61.9%,102,126,64.9%,6,3.1%,18
326,4091.0,189,123,65.1%,116,124,65.6%,1,0.5%,7
327,2063.0,561,459,81.8%,446,476,84.8%,17,3.0%,13
328,7471.0,13,8,61.5%,5,8,61.5%,0,0.0%,3
329,1794.0,72,56,77.8%,55,64,88.9%,8,11.1%,1
330,1623.0,44,31,70.5%,30,32,72.7%,1,2.3%,1
331,3541.0,205,130,63.4%,107,133,64.9%,3,1.5%,23
332,6583.0,97,72,74.2%,56,74,76.3%,2,2.1%,16
333,2686.0,163,120,73.6%,111,129,79.1%,9,5.5%,9
334,685.0,57,45,78.9%,37,45,78.9%,0,0.0%,8
335,6181.0,80,60,75.0%,60,60,75.0%,0,0.0%,0
336,1164.0,121,73,60.3%,62,76,62.8%,3,2.5%,11
337,3040.0,71,37,52.1%,21,38,53.5%,1,1.4%,16
338,5017.0,272,238,87.5%,220,240,88.2%,2,0.7%,18
339,3045.0,174,125,71.8%,123,131,75.3%,6,3.4%,2
340,4044.0,154,118,76.6%,111,129,83.8%,11,7.1%,7
341,4951.0,272,238,87.5%,235,246,90.4%,8,2.9%,3
342,1062.0,64,52,81.3%,44,54,84.4%,2,3.1%,8
343,1550.0,79,44,55.7%,33,48,60.8%,4,5.1%,11
344,6936.0,127,86,67.7%,85,93,73.2%,7,5.5%,1
345,4458.0,188,149,79.3%,146,157,83.5%,8,4.3%,3
346,7944.0,108,57,52.8%,55,64,59.3%,7,6.5%,2
347,4049.0,105,79,75.2%,68,90,85.7%,11,10.5%,11
348,254.0,490,464,94.7%,457,465,94.9%,1,0.2%,7
349,6610.0,262,212,80.9%,205,219,83.6%,7,2.7%,7
350,7546.0,23,22,95.7%,22,23,100.0%,1,4.3%,0
351,3048.0,75,61,81.3%,59,63,84.0%,2,2.7%,2
352,3495.0,389,343,88.2%,334,349,89.7%,6,1.5%,9
353,6455.0,743,607,81.7%,605,639,86.0%,32,4.3%,2
354,2689.0,90,82,91.1%,79,86,95.6%,4,4.4%,3
355,695.0,122,97,79.5%,91,101,82.8%,4,3.3%,6
356,2704.0,200,153,76.5%,140,156,78.0%,3,1.5%,13
357,1084.0,115,105,91.3%,104,106,92.2%,1,0.9%,1
358,4469.0,130,90,69.2%,90,90,69.2%,0,0.0%,0
359,7829.0,69,62,89.9%,51,63,91.3%,1,1.4%,11
360,7930.0,74,54,73.0%,54,54,73.0%,0,0.0%,0
361,6729.0,384,301,78.4%,292,319,83.1%,18,4.7%,9
362,6998.0,44,29,65.9%,26,30,68.2%,1,2.3%,3
363,6793.0,645,605,93.8%,597,606,94.0%,1,0.2%,8
364,1489.0,57,38,66.7%,33,38,66.7%,0,0.0%,5
365,6145.0,144,106,73.6%,98,109,75.7%,3,2.1%,8
366,7101.0,435,373,85.7%,366,383,88.0%,10,2.3%,7
367,5345.0,"1,121",986,88.0%,971,997,88.9%,11,1.0%,15
368,2446.0,230,182,79.1%,180,185,80.4%,3,1.3%,2
369,3883.0,155,105,67.7%,95,111,71.6%,6,3.9%,10
370,3988.0,101,71,70.3%,68,81,80.2%,10,9.9%,3
371,3505.0,463,376,81.2%,365,378,81.6%,2,0.4%,11
372,964.0,62,44,71.0%,43,48,77.4%,4,6.5%,1
373,4577.0,214,143,66.8%,127,155,72.4%,12,5.6%,16
374,747.0,90,56,62.2%,46,63,70.0%,7,7.8%,10
375,6201.0,98,53,54.1%,48,60,61.2%,7,7.1%,5
376,2760.0,212,75,35.4%,65,80,37.7%,5,2.4%,10
377,2818.0,168,122,72.6%,119,124,73.8%,2,1.2%,3
378,3875.0,49,25,51.0%,22,27,55.1%,2,4.1%,3
379,4058.0,62,44,71.0%,40,47,75.8%,3,4.8%,4
380,6372.0,32,24,75.0%,23,25,78.1%,1,3.1%,1
381,6373.0,75,44,58.7%,43,47,62.7%,3,4.0%,1
382,6345.0,258,176,68.2%,162,179,69.4%,3,1.2%,14
383,53.0,108,84,77.8%,79,88,81.5%,4,3.7%,5
384,7562.0,31,23,74.2%,23,23,74.2%,0,0.0%,0
385,2958.0,86,71,82.6%,71,74,86.0%,3,3.5%,0
386,6745.0,160,97,60.6%,73,110,68.8%,13,8.1%,24
387,2821.0,183,138,75.4%,130,140,76.5%,2,1.1%,8
388,4717.0,398,311,78.1%,293,314,78.9%,3,0.8%,18
389,7665.0,143,132,92.3%,128,137,95.8%,5,3.5%,4
390,1414.0,177,135,76.3%,135,137,77.4%,2,1.1%,0
391,4931.0,191,119,62.3%,104,125,65.4%,6,3.1%,15
392,2449.0,70,58,82.9%,58,63,90.0%,5,7.1%,0
393,6318.0,145,112,77.2%,112,113,77.9%,1,0.7%,0
394,3877.0,44,21,47.7%,21,26,59.1%,5,11.4%,0
395,3107.0,65,36,55.4%,32,40,61.5%,4,6.2%,4
396,1406.0,363,316,87.1%,304,324,89.3%,8,2.2%,12
397,1420.0,287,185,64.5%,180,197,68.6%,12,4.2%,5
398,7690.0,97,45,46.4%,36,48,49.5%,3,3.1%,9
399,1094.0,193,153,79.3%,151,154,79.8%,1,0.5%,2
400,4734.0,123,107,87.0%,102,109,88.6%,2,1.6%,5
401,2766.0,249,168,67.5%,167,169,67.9%,1,0.4%,1
402,6693.0,138,90,65.2%,79,95,68.8%,5,3.6%,11
403,2829.0,744,647,87.0%,642,651,87.5%,4,0.5%,5
404,6439.0,131,114,87.0%,113,116,88.5%,2,1.5%,1
405,1213.0,168,98,58.3%,91,98,58.3%,0,0.0%,7
406,309.0,408,238,58.3%,236,252,61.8%,14,3.4%,2
407,2633.0,444,314,70.7%,280,316,71.2%,2,0.5%,34
408,1629.0,81,51,63.0%,51,51,63.0%,0,0.0%,0
409,6942.0,101,53,52.5%,51,53,52.5%,0,0.0%,2
410,6136.0,101,74,73.3%,66,77,76.2%,3,3.0%,8
411,1915.0,297,235,79.1%,222,252,84.8%,17,5.7%,13
412,1100.0,573,458,79.9%,455,477,83.2%,19,3.3%,3
413,2345.0,69,55,79.7%,46,55,79.7%,0,0.0%,9
414,6231.0,123,85,69.1%,84,86,69.9%,1,0.8%,1
415,4682.0,840,773,92.0%,763,786,93.6%,13,1.5%,10
416,7650.0,809,493,60.9%,468,536,66.3%,43,5.3%,25
417,7821.0,56,50,89.3%,44,50,89.3%,0,0.0%,6
418,7819.0,238,97,40.8%,95,110,46.2%,13,5.5%,2
419,6648.0,359,303,84.4%,300,308,85.8%,5,1.4%,3
420,2649.0,143,80,55.9%,67,92,64.3%,12,8.4%,13
421,3328.0,343,292,85.1%,286,295,86.0%,3,0.9%,6
422,7770.0,45,19,42.2%,19,20,44.4%,1,2.2%,0
423,5083.0,351,325,92.6%,320,328,93.4%,3,0.9%,5
424,7587.0,104,73,70.2%,73,74,71.2%,1,1.0%,0
425,3847.0,240,144,60.0%,132,147,61.3%,3,1.3%,12
426,7070.0,122,118,96.7%,118,119,97.5%,1,0.8%,0
427,3840.0,166,3,1.8%,3,3,1.8%,0,0.0%,0
428,3638.0,20,0,0.0%,0,0,0.0%,0,0.0%,0
429,4728.0,21,13,61.9%,13,13,61.9%,0,0.0%,0
430,7023.0,202,0,0.0%,0,0,0.0%,0,0.0%,0
431,3848.0,519,509,98.1%,508,511,98.5%,2,0.4%,1
432,7783.0,39,0,0.0%,0,0,0.0%,0,0.0%,0
433,7676.0,98,0,0.0%,0,0,0.0%,0,0.0%,0
434,7781.0,95,69,72.6%,69,70,73.7%,1,1.1%,0
435,6996.0,147,107,72.8%,106,112,76.2%,5,3.4%,1
436,3841.0,218,147,67.4%,130,172,78.9%,25,11.5%,17
437,3787.0,41,0,0.0%,0,0,0.0%,0,0.0%,0
438,3849.0,312,191,61.2%,177,214,68.6%,23,7.4%,14
439,3816.0,267,159,59.6%,156,167,62.5%,8,3.0%,3
440,7240.0,51,0,0.0%,0,0,0.0%,0,0.0%,0
441,3850.0,310,134,43.2%,127,144,46.5%,10,3.2%,7
442,3851.0,128,62,48.4%,60,65,50.8%,3,2.3%,2
443,6822.0,120,97,80.8%,96,101,84.2%,4,3.3%,1
444,3818.0,141,121,85.8%,121,122,86.5%,1,0.7%,0
445,7664.0,49,47,95.9%,47,47,95.9%,0,0.0%,0
446,3852.0,167,109,65.3%,95,117,70.1%,8,4.8%,14
447,3843.0,249,238,95.6%,238,238,95.6%,0,0.0%,0
448,3853.0,218,105,48.2%,103,116,53.2%,11,5.0%,2
449,7852.0,64,38,59.4%,38,42,65.6%,4,6.3%,0
450,7855.0,55,33,60.0%,30,46,83.6%,13,23.6%,3
451,7851.0,85,53,62.4%,49,56,65.9%,3,3.5%,4
452,6675.0,251,162,64.5%,157,170,67.7%,8,3.2%,5
453,7810.0,91,68,74.7%,62,69,75.8%,1,1.1%,6
454,7811.0,47,0,0.0%,0,0,0.0%,0,0.0%,0
455,3845.0,261,138,52.9%,127,153,58.6%,15,5.7%,11
456,3842.0,177,125,70.6%,123,142,80.2%,17,9.6%,2
457,3808.0,120,118,98.3%,118,118,98.3%,0,0.0%,0
458,3809.0,58,0,0.0%,0,0,0.0%,0,0.0%,0
459,7815.0,34,34,100.0%,33,34,100.0%,0,0.0%,1
460,3855.0,612,465,76.0%,441,477,77.9%,12,2.0%,24
461,7853.0,105,28,26.7%,26,28,26.7%,0,0.0%,2
462,7854.0,99,63,63.6%,54,81,81.8%,18,18.2%,9
463,3857.0,334,237,71.0%,225,282,84.4%,45,13.5%,12
464,6548.0,64,55,85.9%,55,56,87.5%,1,1.6%,0
465,7808.0,90,78,86.7%,73,80,88.9%,2,2.2%,5
466,7782.0,98,98,100.0%,94,98,100.0%,0,0.0%,4
467,7780.0,43,0,0.0%,0,0,0.0%,0,0.0%,0
468,3858.0,160,0,0.0%,0,0,0.0%,0,0.0%,0
469,7814.0,40,0,0.0%,0,0,0.0%,0,0.0%,0
470,7812.0,74,0,0.0%,0,0,0.0%,0,0.0%,0
471,7813.0,50,1,2.0%,1,1,2.0%,0,0.0%,0
472,6522.0,64,0,0.0%,0,0,0.0%,0,0.0%,0
473,3844.0,210,0,0.0%,0,0,0.0%,0,0.0%,0
474,3861.0,89,2,2.2%,2,2,2.2%,0,0.0%,0
475,7245.0,76,33,43.4%,33,42,55.3%,9,11.8%,0
476,3859.0,174,140,80.5%,128,147,84.5%,7,4.0%,12
477,7255.0,117,89,76.1%,85,91,77.8%,2,1.7%,4
478,7072.0,175,101,57.7%,98,129,73.7%,28,16.0%,3
479,6523.0,243,0,0.0%,0,0,0.0%,0,0.0%,0
480,7252.0,47,1,2.1%,1,1,2.1%,0,0.0%,0
481,6527.0,381,253,66.4%,227,261,68.5%,8,2.1%,26
482,3860.0,195,0,0.0%,0,0,0.0%,0,0.0%,0
483,3728.0,9,0,0.0%,0,5,55.6%,5,55.6%,0
484,7737.0,134,75,56.0%,66,76,56.7%,1,0.7%,9
485,1560.0,129,85,65.9%,69,86,66.7%,1,0.8%,16
486,1426.0,244,211,86.5%,204,217,88.9%,6,2.5%,7
487,3910.0,131,82,62.6%,62,91,69.5%,9,6.9%,20
488,315.0,332,302,91.0%,302,307,92.5%,5,1.5%,0
489,409.0,329,279,84.8%,263,287,87.2%,8,2.4%,16
490,6915.0,249,199,79.9%,187,207,83.1%,8,3.2%,12
491,412.0,201,160,79.6%,132,160,79.6%,0,0.0%,28
492,6811.0,12,0,0.0%,0,0,0.0%,0,0.0%,0
493,415.0,118,93,78.8%,92,95,80.5%,2,1.7%,1
494,6047.0,8,0,0.0%,0,0,0.0%,0,0.0%,0
495,422.0,149,109,73.2%,103,116,77.9%,7,4.7%,6
496,424.0,114,65,57.0%,65,65,57.0%,0,0.0%,0
497,416.0,196,155,79.1%,148,162,82.7%,7,3.6%,7
498,6664.0,5,0,0.0%,0,0,0.0%,0,0.0%,0
499,7103.0,132,120,90.9%,119,121,91.7%,1,0.8%,1
500,425.0,227,211,93.0%,203,213,93.8%,2,0.9%,8
501,420.0,74,44,59.5%,42,48,64.9%,4,5.4%,2
502,5058.0,246,205,83.3%,196,205,83.3%,0,0.0%,9
503,3210.0,539,0,0.0%,0,0,0.0%,0,0.0%,0
504,435.0,373,324,86.9%,309,329,88.2%,5,1.3%,15
505,7771.0,2,1,50.0%,1,2,100.0%,1,50.0%,0
506,3216.0,475,370,77.9%,362,374,78.7%,4,0.8%,8
507,7738.0,475,348,73.3%,342,351,73.9%,3,0.6%,6
508,3111.0,99,63,63.6%,56,69,69.7%,6,6.1%,7
509,1270.0,68,48,70.6%,43,49,72.1%,1,1.5%,5
510,3338.0,154,135,87.7%,131,137,89.0%,2,1.3%,4
511,3348.0,169,127,75.1%,113,136,80.5%,9,5.3%,14
512,3924.0,275,197,71.6%,177,199,72.4%,2,0.7%,20
513,7540.0,149,124,83.2%,122,126,84.6%,2,1.3%,2
514,6165.0,229,155,67.7%,130,162,70.7%,7,3.1%,25
515,2350.0,78,38,48.7%,36,44,56.4%,6,7.7%,2
516,448.0,148,133,89.9%,132,135,91.2%,2,1.4%,1
517,1128.0,373,319,85.5%,311,323,86.6%,4,1.1%,8
518,1921.0,271,244,90.0%,242,244,90.0%,0,0.0%,2
519,859.0,716,427,59.6%,404,438,61.2%,11,1.5%,23
520,4598.0,366,261,71.3%,229,270,73.8%,9,2.5%,32
521,1495.0,84,47,56.0%,43,49,58.3%,2,2.4%,4
522,7636.0,32,32,100.0%,32,32,100.0%,0,0.0%,0
523,3165.0,102,66,64.7%,61,67,65.7%,1,1.0%,5
524,7941.0,134,0,0.0%,0,0,0.0%,0,0.0%,0
525,1989.0,91,74,81.3%,61,74,81.3%,0,0.0%,13
526,1934.0,469,371,79.1%,359,384,81.9%,13,2.8%,12
527,7019.0,266,195,73.3%,180,203,76.3%,8,3.0%,15
528,700.0,165,116,70.3%,108,123,74.5%,7,4.2%,8
529,2496.0,119,92,77.3%,92,95,79.8%,3,2.5%,0
530,6928.0,101,88,87.1%,84,88,87.1%,0,0.0%,4
531,7629.0,28,27,96.4%,27,28,100.0%,1,3.6%,0
532,712.0,55,44,80.0%,37,44,80.0%,0,0.0%,7
533,6210.0,65,0,0.0%,0,0,0.0%,0,0.0%,0
534,1942.0,288,261,90.6%,259,267,92.7%,6,2.1%,2
535,5169.0,190,134,70.5%,125,140,73.7%,6,3.2%,9
536,2833.0,146,123,84.2%,122,123,84.2%,0,0.0%,1
537,4002.0,35,25,71.4%,24,25,71.4%,0,0.0%,1
538,5352.0,190,147,77.4%,143,150,78.9%,3,1.6%,4
539,965.0,71,47,66.2%,47,53,74.6%,6,8.5%,0
540,5264.0,99,68,68.7%,65,74,74.7%,6,6.1%,3
541,864.0,161,128,79.5%,123,136,84.5%,8,5.0%,5
542,7124.0,25,22,88.0%,22,22,88.0%,0,0.0%,0
543,6413.0,479,434,90.6%,424,452,94.4%,18,3.8%,10
544,2489.0,279,256,91.8%,248,271,97.1%,15,5.4%,8
545,3969.0,209,156,74.6%,155,161,77.0%,5,2.4%,1
546,1183.0,542,467,86.2%,444,470,86.7%,3,0.6%,23
547,4006.0,47,23,48.9%,21,25,53.2%,2,4.3%,2
548,460.0,435,211,48.5%,199,211,48.5%,0,0.0%,12
549,7893.0,142,101,71.1%,95,102,71.8%,1,0.7%,6
550,6800.0,45,29,64.4%,29,30,66.7%,1,2.2%,0
551,5246.0,142,77,54.2%,75,77,54.2%,0,0.0%,2
552,3124.0,109,83,76.1%,81,90,82.6%,7,6.4%,2
553,3940.0,72,43,59.7%,38,48,66.7%,5,6.9%,5
554,2708.0,122,82,67.2%,81,92,75.4%,10,8.2%,1
555,3569.0,208,115,55.3%,102,118,56.7%,3,1.4%,13
556,5221.0,236,181,76.7%,167,182,77.1%,1,0.4%,14
557,1172.0,166,144,86.7%,140,145,87.3%,1,0.6%,4
558,3117.0,69,39,56.5%,31,46,66.7%,7,10.1%,8
559,2658.0,304,166,54.6%,162,176,57.9%,10,3.3%,4
560,4015.0,221,141,63.8%,133,149,67.4%,8,3.6%,8
561,3354.0,496,421,84.9%,393,422,85.1%,1,0.2%,28
562,440.0,133,112,84.2%,100,112,84.2%,0,0.0%,12
563,1177.0,253,208,82.2%,208,209,82.6%,1,0.4%,0
564,4602.0,247,187,75.7%,187,193,78.1%,6,2.4%,0
565,470.0,127,119,93.7%,111,120,94.5%,1,0.8%,8
566,6328.0,179,151,84.4%,145,153,85.5%,2,1.1%,6
567,467.0,188,168,89.4%,168,170,90.4%,2,1.1%,0
568,714.0,109,84,77.1%,84,85,78.0%,1,0.9%,0
569,4608.0,299,224,74.9%,216,241,80.6%,17,5.7%,8
570,3056.0,91,64,70.3%,64,66,72.5%,2,2.2%,0
571,6516.0,200,151,75.5%,144,164,82.0%,13,6.5%,7
572,2284.0,40,23,57.5%,23,23,57.5%,0,0.0%,0
573,1627.0,112,90,80.4%,87,94,83.9%,4,3.6%,3
574,2253.0,63,45,71.4%,38,45,71.4%,0,0.0%,7
575,2313.0,109,59,54.1%,54,61,56.0%,2,1.8%,5
576,2839.0,249,201,80.7%,200,209,83.9%,8,3.2%,1
577,4064.0,50,28,56.0%,28,31,62.0%,3,6.0%,0
578,4068.0,87,55,63.2%,44,58,66.7%,3,3.4%,11
579,4071.0,49,27,55.1%,27,27,55.1%,0,0.0%,0
580,4614.0,282,212,75.2%,205,219,77.7%,7,2.5%,7
581,6191.0,153,102,66.7%,102,124,81.0%,22,14.4%,0
582,7648.0,2,1,50.0%,1,1,50.0%,0,0.0%,0
583,941.0,149,87,58.4%,82,90,60.4%,3,2.0%,5
584,4623.0,283,204,72.1%,179,222,78.4%,18,6.4%,25
585,1950.0,283,261,92.2%,259,262,92.6%,1,0.4%,2
586,3376.0,191,175,91.6%,173,175,91.6%,0,0.0%,2
587,3367.0,442,382,86.4%,374,398,90.0%,16,3.6%,8
588,1364.0,656,572,87.2%,548,576,87.8%,4,0.6%,24
589,196.0,147,103,70.1%,90,113,76.9%,10,6.8%,13
590,1801.0,66,32,48.5%,30,34,51.5%,2,3.0%,2
591,477.0,96,43,44.8%,43,53,55.2%,10,10.4%,0
592,3224.0,436,318,72.9%,318,318,72.9%,0,0.0%,0
593,7635.0,31,13,41.9%,13,13,41.9%,0,0.0%,0
594,4030.0,56,34,60.7%,33,34,60.7%,0,0.0%,1
595,7567.0,49,7,14.3%,7,10,20.4%,3,6.1%,0
596,4054.0,62,46,74.2%,46,50,80.6%,4,6.5%,0
597,1806.0,254,230,90.6%,215,231,90.9%,1,0.4%,15
598,3589.0,148,104,70.3%,102,104,70.3%,0,0.0%,2
599,5070.0,156,137,87.8%,129,137,87.8%,0,0.0%,8
600,7833.0,15,6,40.0%,5,8,53.3%,2,13.3%,1
601,1668.0,159,120,75.5%,116,120,75.5%,0,0.0%,4
602,5208.0,145,82,56.6%,76,93,64.1%,11,7.6%,6
603,1423.0,491,476,96.9%,475,479,97.6%,3,0.6%,1
604,6012.0,272,206,75.7%,182,216,79.4%,10,3.7%,24
605,3957.0,73,48,65.8%,37,50,68.5%,2,2.7%,11
606,1000.0,120,78,65.0%,77,79,65.8%,1,0.8%,1
607,4670.0,116,72,62.1%,69,79,68.1%,7,6.0%,3
608,5271.0,259,185,71.4%,178,189,73.0%,4,1.5%,7
609,6216.0,18,7,38.9%,7,7,38.9%,0,0.0%,0
610,7762.0,77,17,22.1%,16,18,23.4%,1,1.3%,1
611,6280.0,207,92,44.4%,92,118,57.0%,26,12.6%,0
612,753.0,99,54,54.5%,47,58,58.6%,4,4.0%,7
613,873.0,235,189,80.4%,189,190,80.9%,1,0.4%,0
614,949.0,139,99,71.2%,91,110,79.1%,11,7.9%,8
615,2712.0,54,48,88.9%,43,49,90.7%,1,1.9%,5
616,2075.0,85,37,43.5%,35,49,57.6%,12,14.1%,2
617,1501.0,45,26,57.8%,22,27,60.0%,1,2.2%,4
618,2184.0,221,159,71.9%,143,165,74.7%,6,2.7%,16
619,1443.0,311,298,95.8%,298,301,96.8%,3,1.0%,0
620,2358.0,110,76,69.1%,76,77,70.0%,1,0.9%,0
621,21.0,142,93,65.5%,78,97,68.3%,4,2.8%,15
622,1972.0,783,578,73.8%,578,591,75.5%,13,1.7%,0
623,6340.0,82,57,69.5%,56,59,72.0%,2,2.4%,1
624,5078.0,403,383,95.0%,383,385,95.5%,2,0.5%,0
625,3395.0,237,216,91.1%,210,216,91.1%,0,0.0%,6
626,3401.0,226,164,72.6%,164,176,77.9%,12,5.3%,0
627,5081.0,211,158,74.9%,154,165,78.2%,7,3.3%,4
628,492.0,340,325,95.6%,324,326,95.9%,1,0.3%,1
629,4126.0,70,49,70.0%,49,49,70.0%,0,0.0%,0
630,6775.0,186,151,81.2%,147,155,83.3%,4,2.2%,4
631,4310.0,301,227,75.4%,216,238,79.1%,11,3.7%,11
632,5287.0,322,280,87.0%,276,282,87.6%,2,0.6%,4
633,4143.0,98,75,76.5%,75,79,80.6%,4,4.1%,0
634,4146.0,44,22,50.0%,16,26,59.1%,4,9.1%,6
635,4149.0,196,143,73.0%,143,144,73.5%,1,0.5%,0
636,4135.0,90,47,52.2%,46,56,62.2%,9,10.0%,1
637,5103.0,124,83,66.9%,72,104,83.9%,21,16.9%,11
638,2663.0,343,249,72.6%,237,263,76.7%,14,4.1%,12
639,4286.0,124,86,69.4%,69,88,71.0%,2,1.6%,17
640,6148.0,115,67,58.3%,58,80,69.6%,13,11.3%,9
641,4295.0,258,171,66.3%,164,184,71.3%,13,5.0%,7
642,2243.0,312,192,61.5%,188,209,67.0%,17,5.4%,4
643,1327.0,67,54,80.6%,54,54,80.6%,0,0.0%,0
644,4080.0,107,80,74.8%,73,82,76.6%,2,1.9%,7
645,509.0,243,207,85.2%,194,215,88.5%,8,3.3%,13
646,1566.0,94,52,55.3%,44,53,56.4%,1,1.1%,8
647,7894.0,279,250,89.6%,247,260,93.2%,10,3.6%,3
648,6734.0,356,322,90.4%,320,330,92.7%,8,2.2%,2
649,1453.0,306,272,88.9%,269,273,89.2%,1,0.3%,3
650,7136.0,77,47,61.0%,47,47,61.0%,0,0.0%,0
651,523.0,258,187,72.5%,181,188,72.9%,1,0.4%,6
652,6129.0,79,59,74.7%,57,64,81.0%,5,6.3%,2
653,536.0,259,231,89.2%,208,232,89.6%,1,0.4%,23
654,3596.0,193,98,50.8%,87,107,55.4%,9,4.7%,11
655,1732.0,327,260,79.5%,260,260,79.5%,0,0.0%,0
656,4704.0,298,214,71.8%,203,225,75.5%,11,3.7%,11
657,5059.0,102,33,32.4%,32,38,37.3%,5,4.9%,1
658,6705.0,167,148,88.6%,142,151,90.4%,3,1.8%,6
659,719.0,63,46,73.0%,45,48,76.2%,2,3.2%,1
660,4959.0,121,62,51.2%,39,62,51.2%,0,0.0%,23
661,6704.0,186,130,69.9%,126,143,76.9%,13,7.0%,4
662,1293.0,147,128,87.1%,127,129,87.8%,1,0.7%,1
663,2848.0,355,264,74.4%,263,272,76.6%,8,2.3%,1
664,3009.0,165,119,72.1%,116,126,76.4%,7,4.2%,3
665,3008.0,117,88,75.2%,78,88,75.2%,0,0.0%,10
666,3007.0,236,176,74.6%,171,182,77.1%,6,2.5%,5
667,555.0,85,67,78.8%,57,67,78.8%,0,0.0%,10
668,1892.0,364,251,69.0%,246,278,76.4%,27,7.4%,5
669,3914.0,91,60,65.9%,49,64,70.3%,4,4.4%,11
670,951.0,46,24,52.2%,24,25,54.3%,1,2.2%,0
671,6368.0,368,197,53.5%,197,204,55.4%,7,1.9%,0
672,2721.0,131,99,75.6%,95,113,86.3%,14,10.7%,4
673,6980.0,441,362,82.1%,354,378,85.7%,16,3.6%,8
674,3522.0,177,130,73.4%,127,134,75.7%,4,2.3%,3
675,4026.0,99,77,77.8%,76,79,79.8%,2,2.0%,1
676,3247.0,333,307,92.2%,307,307,92.2%,0,0.0%,0
677,107.0,316,263,83.2%,243,266,84.2%,3,0.9%,20
678,7512.0,44,44,100.0%,43,44,100.0%,0,0.0%,1
679,1005.0,101,68,67.3%,64,69,68.3%,1,1.0%,4
680,6390.0,208,175,84.1%,175,183,88.0%,8,3.8%,0
681,6391.0,356,266,74.7%,260,282,79.2%,16,4.5%,6
682,887.0,148,136,91.9%,131,136,91.9%,0,0.0%,5
683,4647.0,254,58,22.8%,58,80,31.5%,22,8.7%,0
684,5168.0,98,17,17.3%,17,21,21.4%,4,4.1%,0
685,7345.0,185,64,34.6%,47,85,45.9%,21,11.4%,17
686,4658.0,179,158,88.3%,144,159,88.8%,1,0.6%,14
687,4735.0,190,129,67.9%,123,140,73.7%,11,5.8%,6
688,7513.0,97,43,44.3%,25,45,46.4%,2,2.1%,18
689,,,,,,,,,,
690,,"130,296","94,238",72.3%,"89,950","97,711",75.0%,"3,473",2.7%,"4,288"
