,school number,graduate count,college bound,total college bound %,2- or 4-year college or university,2- or 4-year university %,total postsecondary bound,total postsecondary bound %,non-degree-granting postsecondary school,non-degree-granting postsecondary school %,specialized associate degree granting institution
0,3.0,160,102,63.75%,93,58.13%,107,66.88%,5,3.13%,9
1,17.0,277,209,75.45%,195,70.40%,217,78.34%,8,2.89%,14
3,6269.0,91,65,71.43%,61,67.03%,67,73.63%,2,2.20%,4
5,6271.0,222,167,75.23%,154,69.37%,173,77.93%,6,2.70%,13
7,14.0,154,81,52.60%,73,47.40%,89,57.79%,8,5.19%,8
9,21.0,121,84,69.42%,78,64.46%,90,74.38%,6,4.96%,6
11,7727.0,141,113,80.14%,111,78.72%,116,82.27%,3,2.13%,2
12,7846.0,25,11,44.00%,11,44.00%,11,44.00%,0,0.00%,0
13,7562.0,34,32,94.12%,32,94.12%,33,97.06%,1,2.94%,0
14,409.0,314,221,70.38%,221,70.38%,222,70.70%,1,0.32%,0
15,412.0,162,114,70.37%,107,66.05%,118,72.84%,4,2.47%,7
16,416.0,164,110,67.07%,103,62.80%,112,68.29%,2,1.22%,7
17,6047.0,13,0,0.00%,0,0.00%,0,0.00%,0,0.00%,0
18,6664.0,3,0,0.00%,0,0.00%,0,0.00%,0,0.00%,0
19,6811.0,21,0,0.00%,0,0.00%,0,0.00%,0,0.00%,0
20,6915.0,256,208,81.25%,207,80.86%,220,85.94%,12,4.69%,1
21,8105.0,78,0,0.00%,0,0.00%,0,0.00%,0,0.00%,0
22,8106.0,138,136,98.55%,134,97.10%,136,98.55%,0,0.00%,2
23,8107.0,66,59,89.39%,58,87.88%,59,89.39%,0,0.00%,1
24,8110.0,89,79,88.76%,79,88.76%,79,88.76%,0,0.00%,0
25,8203.0,53,28,52.83%,28,52.83%,31,58.49%,3,5.66%,0
26,8300.0,18,11,61.11%,11,61.11%,13,72.22%,2,11.11%,0
28,7772.0,46,1,2.17%,1,2.17%,1,2.17%,0,0.00%,0
29,29.0,71,48,67.61%,47,66.20%,52,73.24%,4,5.63%,1
30,5199.0,80,75,93.75%,72,90.00%,75,93.75%,0,0.00%,3
32,315.0,381,334,87.66%,334,87.66%,341,89.50%,7,1.84%,0
33,50.0,349,282,80.80%,274,78.51%,293,83.95%,11,3.15%,8
35,62.0,383,322,84.07%,311,81.20%,322,84.07%,0,0.00%,11
36,70.0,109,97,88.99%,96,88.07%,100,91.74%,3,2.75%,1
38,0.0,1,0,0.00%,0,0.00%,0,0.00%,0,0.00%,0
39,79.0,87,59,67.82%,58,66.67%,61,70.11%,2,2.30%,1
41,6706.0,252,219,86.90%,217,86.11%,222,88.10%,3,1.19%,2
43,8094.0,42,30,71.43%,28,66.67%,30,71.43%,0,0.00%,2
45,8087.0,45,40,88.89%,33,73.33%,40,88.89%,0,0.00%,7
46,513.0,139,107,76.98%,107,76.98%,121,87.05%,14,10.07%,0
48,5193.0,124,104,83.87%,102,82.26%,107,86.29%,3,2.42%,2
50,144.0,195,134,68.72%,123,63.08%,139,71.28%,5,2.56%,11
51,7648.0,3,1,33.33%,1,33.33%,1,33.33%,0,0.00%,0
52,156.0,338,296,87.57%,285,84.32%,298,88.17%,2,0.59%,11
54,0.0,5,0,0.00%,0,0.00%,0,0.00%,0,0.00%,0
55,170.0,292,135,46.23%,135,46.23%,136,46.58%,1,0.34%,0
56,5190.0,278,239,85.97%,237,85.25%,245,88.13%,6,2.16%,2
58,5153.0,159,94,59.12%,94,59.12%,108,67.92%,14,8.81%,0
59,5112.0,171,136,79.53%,126,73.68%,136,79.53%,0,0.00%,10
60,6105.0,257,162,63.04%,153,59.53%,224,87.16%,62,24.12%,9
61,5017.0,247,211,85.43%,206,83.40%,212,85.83%,1,0.40%,5
63,4951.0,269,225,83.64%,220,81.78%,227,84.39%,2,0.74%,5
65,254.0,430,404,93.95%,398,92.56%,406,94.42%,2,0.47%,6
67,8305.0,680,630,92.65%,621,91.32%,634,93.24%,4,0.59%,9
69,53.0,74,65,87.84%,60,81.08%,67,90.54%,2,2.70%,5
71,7101.0,343,283,82.51%,275,80.17%,294,85.71%,11,3.21%,8
72,309.0,312,252,80.77%,239,76.60%,268,85.90%,16,5.13%,13
74,435.0,305,250,81.97%,242,79.34%,258,84.59%,8,2.62%,8
75,448.0,151,138,91.39%,138,91.39%,138,91.39%,0,0.00%,0
77,6928.0,74,66,89.19%,64,86.49%,66,89.19%,0,0.00%,2
79,460.0,358,291,81.28%,282,78.77%,304,84.92%,13,3.63%,9
81,440.0,117,91,77.78%,91,77.78%,96,82.05%,5,4.27%,0
83,470.0,145,126,86.90%,126,86.90%,132,91.03%,6,4.14%,0
85,467.0,164,154,93.90%,154,93.90%,154,93.90%,0,0.00%,0
87,196.0,132,82,62.12%,75,56.82%,82,62.12%,0,0.00%,7
89,477.0,83,57,68.67%,57,68.67%,57,68.67%,0,0.00%,0
91,492.0,344,323,93.90%,322,93.60%,323,93.90%,0,0.00%,1
92,509.0,216,181,83.80%,178,82.41%,183,84.72%,2,0.93%,3
93,523.0,199,164,82.41%,162,81.41%,169,84.92%,5,2.51%,2
95,536.0,232,176,75.86%,160,68.97%,183,78.88%,7,3.02%,16
97,555.0,33,4,12.12%,4,12.12%,7,21.21%,3,9.09%,0
99,107.0,232,192,82.76%,183,78.88%,199,85.78%,7,3.02%,9
101,7821.0,37,29,78.38%,25,67.57%,29,78.38%,0,0.00%,4
102,8129.0,83,0,0.00%,0,0.00%,0,0.00%,0,0.00%,0
103,2320.0,81,40,49.38%,39,48.15%,46,56.79%,6,7.41%,1
105,596.0,121,0,0.00%,0,0.00%,0,0.00%,0,0.00%,0
106,6575.0,89,64,71.91%,64,71.91%,65,73.03%,1,1.12%,0
107,7640.0,77,61,79.22%,52,67.53%,64,83.12%,3,3.90%,9
109,594.0,136,120,88.24%,120,88.24%,120,88.24%,0,0.00%,0
110,7923.0,43,33,76.74%,31,72.09%,33,76.74%,0,0.00%,2
111,4807.0,196,57,29.08%,56,28.57%,77,39.29%,20,10.20%,1
112,7847.0,19,13,68.42%,13,68.42%,14,73.68%,1,5.26%,0
113,7859.0,130,107,82.31%,107,82.31%,115,88.46%,8,6.15%,0
114,8086.0,62,27,43.55%,27,43.55%,27,43.55%,0,0.00%,0
116,6555.0,186,121,65.05%,111,59.68%,121,65.05%,0,0.00%,10
117,640.0,143,111,77.62%,107,74.83%,113,79.02%,2,1.40%,4
118,649.0,96,51,53.13%,47,48.96%,52,54.17%,1,1.04%,4
119,6707.0,163,142,87.12%,135,82.82%,144,88.34%,2,1.23%,7
121,8044.0,169,115,68.05%,115,68.05%,125,73.96%,10,5.92%,0
123,6563.0,110,81,73.64%,81,73.64%,83,75.45%,2,1.82%,0
125,7650.0,"1,367",815,59.62%,723,52.89%,859,62.84%,44,3.22%,92
126,675.0,175,123,70.29%,123,70.29%,123,70.29%,0,0.00%,0
128,695.0,109,82,75.23%,75,68.81%,84,77.06%,2,1.83%,7
130,700.0,120,78,65.00%,77,64.17%,89,74.17%,11,9.17%,1
132,8000.0,59,42,71.19%,39,66.10%,42,71.19%,0,0.00%,3
134,714.0,80,70,87.50%,70,87.50%,70,87.50%,0,0.00%,0
135,719.0,43,28,65.12%,28,65.12%,32,74.42%,4,9.30%,0
137,726.0,142,66,46.48%,63,44.37%,70,49.30%,4,2.82%,3
139,732.0,122,72,59.02%,56,45.90%,74,60.66%,2,1.64%,16
141,7897.0,96,48,50.00%,45,46.88%,52,54.17%,4,4.17%,3
143,747.0,84,48,57.14%,45,53.57%,56,66.67%,8,9.52%,3
144,8154.0,19,7,36.84%,7,36.84%,8,42.11%,1,5.26%,0
145,753.0,76,44,57.89%,37,48.68%,50,65.79%,6,7.89%,7
146,8155.0,65,56,86.15%,56,86.15%,60,92.31%,4,6.15%,0
147,820.0,68,47,69.12%,44,64.71%,47,69.12%,0,0.00%,3
149,6306.0,474,357,75.32%,339,71.52%,373,78.69%,16,3.38%,18
151,6308.0,110,77,70.00%,74,67.27%,77,70.00%,0,0.00%,3
152,777.0,208,153,73.56%,151,72.60%,162,77.88%,9,4.33%,2
154,4810.0,276,219,79.35%,219,79.35%,219,79.35%,0,0.00%,0
156,788.0,331,269,81.27%,265,80.06%,278,83.99%,9,2.72%,4
158,5023.0,178,132,74.16%,129,72.47%,135,75.84%,3,1.69%,3
160,802.0,299,216,72.24%,211,70.57%,218,72.91%,2,0.67%,5
161,808.0,155,113,72.90%,99,63.87%,115,74.19%,2,1.29%,14
162,816.0,112,73,65.18%,69,61.61%,75,66.96%,2,1.79%,4
163,6610.0,271,199,73.43%,189,69.74%,210,77.49%,11,4.06%,10
165,6318.0,164,122,74.39%,118,71.95%,130,79.27%,8,4.88%,4
167,8116.0,726,426,58.68%,425,58.54%,467,64.33%,41,5.65%,1
169,864.0,150,117,78.00%,112,74.67%,124,82.67%,7,4.67%,5
171,4670.0,89,47,52.81%,47,52.81%,51,57.30%,4,4.49%,0
173,873.0,209,153,73.21%,146,69.86%,157,75.12%,4,1.91%,7
174,6980.0,461,347,75.27%,331,71.80%,358,77.66%,11,2.39%,16
176,887.0,149,127,85.23%,123,82.55%,129,86.58%,2,1.34%,4
177,7720.0,12,7,58.33%,7,58.33%,7,58.33%,0,0.00%,0
178,913.0,501,310,61.88%,300,59.88%,321,64.07%,11,2.20%,10
179,7425.0,3,0,0.00%,0,0.00%,0,0.00%,0,0.00%,0
180,917.0,107,62,57.94%,62,57.94%,63,58.88%,1,0.93%,0
181,921.0,68,39,57.35%,26,38.24%,41,60.29%,2,2.94%,13
183,5207.0,234,153,65.38%,147,62.82%,165,70.51%,12,5.13%,6
184,941.0,130,82,63.08%,75,57.69%,87,66.92%,5,3.85%,7
185,949.0,125,83,66.40%,71,56.80%,85,68.00%,2,1.60%,12
186,951.0,48,26,54.17%,23,47.92%,29,60.42%,3,6.25%,3
187,958.0,139,74,53.24%,74,53.24%,78,56.12%,4,2.88%,0
188,988.0,58,26,44.83%,26,44.83%,30,51.72%,4,6.90%,0
189,964.0,68,41,60.29%,41,60.29%,42,61.76%,1,1.47%,0
190,965.0,72,49,68.06%,49,68.06%,51,70.83%,2,2.78%,0
191,5208.0,106,60,56.60%,58,54.72%,61,57.55%,1,0.94%,2
192,1000.0,112,64,57.14%,63,56.25%,64,57.14%,0,0.00%,1
193,1005.0,93,58,62.37%,58,62.37%,59,63.44%,1,1.08%,0
194,7726.0,36,18,50.00%,18,50.00%,21,58.33%,3,8.33%,0
196,5116.0,400,334,83.50%,330,82.50%,346,86.50%,12,3.00%,4
197,1014.0,72,53,73.61%,46,63.89%,53,73.61%,0,0.00%,7
199,1029.0,323,254,78.64%,222,68.73%,255,78.95%,1,0.31%,32
201,1030.0,349,208,59.60%,179,51.29%,211,60.46%,3,0.86%,29
202,1040.0,451,375,83.15%,374,82.93%,388,86.03%,13,2.88%,1
204,1043.0,495,452,91.31%,452,91.31%,452,91.31%,0,0.00%,0
205,5133.0,504,471,93.45%,471,93.45%,473,93.85%,2,0.40%,0
206,7790.0,612,561,91.67%,558,91.18%,565,92.32%,4,0.65%,3
208,5096.0,448,429,95.76%,427,95.31%,430,95.98%,1,0.22%,2
209,7749.0,476,431,90.55%,429,90.13%,439,92.23%,8,1.68%,2
211,8114.0,65,47,72.31%,47,72.31%,48,73.85%,1,1.54%,0
213,6455.0,644,537,83.39%,537,83.39%,561,87.11%,24,3.73%,0
215,1084.0,120,111,92.50%,111,92.50%,114,95.00%,3,2.50%,0
217,1094.0,163,124,76.07%,120,73.62%,126,77.30%,2,1.23%,4
219,1100.0,545,465,85.32%,465,85.32%,468,85.87%,3,0.55%,0
221,4682.0,772,632,81.87%,630,81.61%,657,85.10%,25,3.24%,2
222,1128.0,379,308,81.27%,306,80.74%,308,81.27%,0,0.00%,2
224,1147.0,539,462,85.71%,450,83.49%,487,90.35%,25,4.64%,12
226,1154.0,119,78,65.55%,71,59.66%,81,68.07%,3,2.52%,7
228,1159.0,246,224,91.06%,223,90.65%,227,92.28%,3,1.22%,1
230,1164.0,85,60,70.59%,56,65.88%,65,76.47%,5,5.88%,4
232,1172.0,144,103,71.53%,102,70.83%,105,72.92%,2,1.39%,1
233,1177.0,237,178,75.11%,178,75.11%,185,78.06%,7,2.95%,0
234,8318.0,559,493,88.19%,480,85.87%,500,89.45%,7,1.25%,13
235,5135.0,33,18,54.55%,17,51.52%,20,60.61%,2,6.06%,1
236,5212.0,101,71,70.30%,60,59.41%,71,70.30%,0,0.00%,11
237,1208.0,115,85,73.91%,80,69.57%,92,80.00%,7,6.09%,5
238,5136.0,59,38,64.41%,36,61.02%,41,69.49%,3,5.08%,2
240,1225.0,36,26,72.22%,26,72.22%,28,77.78%,2,5.56%,0
241,1191.0,139,92,66.19%,83,59.71%,99,71.22%,7,5.04%,9
242,1251.0,148,83,56.08%,78,52.70%,86,58.11%,3,2.03%,5
243,8314.0,1,0,0.00%,0,0.00%,0,0.00%,0,0.00%,0
244,6201.0,96,63,65.63%,53,55.21%,63,65.63%,0,0.00%,10
245,1213.0,107,88,82.24%,87,81.31%,88,82.24%,0,0.00%,1
246,1270.0,63,44,69.84%,44,69.84%,50,79.37%,6,9.52%,0
248,7941.0,135,106,78.52%,101,74.81%,109,80.74%,3,2.22%,5
249,1293.0,122,106,86.89%,106,86.89%,106,86.89%,0,0.00%,0
250,1299.0,49,30,61.22%,29,59.18%,31,63.27%,1,2.04%,1
251,4870.0,79,35,44.30%,35,44.30%,43,54.43%,8,10.13%,0
252,1307.0,115,89,77.39%,86,74.78%,93,80.87%,4,3.48%,3
254,1315.0,163,125,76.69%,118,72.39%,127,77.91%,2,1.23%,7
255,4734.0,149,106,71.14%,106,71.14%,119,79.87%,13,8.72%,0
257,6693.0,87,60,68.97%,60,68.97%,62,71.26%,2,2.30%,0
258,1327.0,47,32,68.09%,30,63.83%,33,70.21%,1,2.13%,2
260,1335.0,108,64,59.26%,57,52.78%,65,60.19%,1,0.93%,7
261,1343.0,184,105,57.07%,102,55.43%,110,59.78%,5,2.72%,3
263,6231.0,109,84,77.06%,72,66.06%,84,77.06%,0,0.00%,12
264,1364.0,568,464,81.69%,459,80.81%,467,82.22%,3,0.53%,5
265,7691.0,116,57,49.14%,57,49.14%,61,52.59%,4,3.45%,0
266,7721.0,69,48,69.57%,47,68.12%,53,76.81%,5,7.25%,1
267,7819.0,268,184,68.66%,166,61.94%,196,73.13%,12,4.48%,18
268,1367.0,411,356,86.62%,350,85.16%,364,88.56%,8,1.95%,6
270,7293.0,179,132,73.74%,128,71.51%,136,75.98%,4,2.23%,4
271,5012.0,512,339,66.21%,339,66.21%,387,75.59%,48,9.38%,0
272,1387.0,348,309,88.79%,306,87.93%,313,89.94%,4,1.15%,3
273,7759.0,384,367,95.57%,367,95.57%,370,96.35%,3,0.78%,0
274,8174.0,170,169,99.41%,169,99.41%,170,100.00%,1,0.59%,0
276,7628.0,40,37,92.50%,37,92.50%,38,95.00%,1,2.50%,0
277,7636.0,73,64,87.67%,64,87.67%,66,90.41%,2,2.74%,0
278,1424.0,289,275,95.16%,275,95.16%,276,95.50%,1,0.35%,0
280,6482.0,297,226,76.09%,223,75.08%,232,78.11%,6,2.02%,3
282,1414.0,192,143,74.48%,124,64.58%,145,75.52%,2,1.04%,19
284,1406.0,342,315,92.11%,310,90.64%,317,92.69%,2,0.58%,5
286,1420.0,304,215,70.72%,208,68.42%,225,74.01%,10,3.29%,7
287,1426.0,247,217,87.85%,217,87.85%,229,92.71%,12,4.86%,0
289,1423.0,497,489,98.39%,489,98.39%,491,98.79%,2,0.40%,0
291,1443.0,327,309,94.50%,308,94.19%,310,94.80%,1,0.31%,1
293,1453.0,272,253,93.01%,253,93.01%,258,94.85%,5,1.84%,0
294,6734.0,358,324,90.50%,323,90.22%,336,93.85%,12,3.35%,1
295,7894.0,318,299,94.03%,299,94.03%,305,95.91%,6,1.89%,0
297,7824.0,113,45,39.82%,44,38.94%,52,46.02%,7,6.19%,1
298,7858.0,906,406,44.81%,381,42.05%,481,53.09%,75,8.28%,25
299,4664.0,55,32,58.18%,32,58.18%,38,69.09%,6,10.91%,0
301,1475.0,57,44,77.19%,42,73.68%,45,78.95%,1,1.75%,2
302,1480.0,65,42,64.62%,40,61.54%,43,66.15%,1,1.54%,2
304,1486.0,75,54,72.00%,51,68.00%,57,76.00%,3,4.00%,3
306,1489.0,59,40,67.80%,40,67.80%,41,69.49%,1,1.69%,0
307,1495.0,77,50,64.94%,46,59.74%,50,64.94%,0,0.00%,4
308,1501.0,44,33,75.00%,28,63.64%,33,75.00%,0,0.00%,5
309,6156.0,254,146,57.48%,127,50.00%,160,62.99%,14,5.51%,19
311,6236.0,164,94,57.32%,78,47.56%,102,62.20%,8,4.88%,16
312,1529.0,75,55,73.33%,55,73.33%,55,73.33%,0,0.00%,0
313,5219.0,65,36,55.38%,35,53.85%,40,61.54%,4,6.15%,1
314,8316.0,23,11,47.83%,10,43.48%,11,47.83%,0,0.00%,1
315,1550.0,54,31,57.41%,26,48.15%,34,62.96%,3,5.56%,5
317,1560.0,119,75,63.03%,71,59.66%,82,68.91%,7,5.88%,4
318,1566.0,73,49,67.12%,45,61.64%,49,67.12%,0,0.00%,4
319,7635.0,26,9,34.62%,9,34.62%,9,34.62%,0,0.00%,0
320,6241.0,28,15,53.57%,15,53.57%,19,67.86%,4,14.29%,0
321,7589.0,266,164,61.65%,146,54.89%,168,63.16%,4,1.50%,18
323,1595.0,49,36,73.47%,36,73.47%,38,77.55%,2,4.08%,0
324,1605.0,210,158,75.24%,156,74.29%,168,80.00%,10,4.76%,2
325,1612.0,97,71,73.20%,70,72.16%,71,73.20%,0,0.00%,1
327,1619.0,124,90,72.58%,89,71.77%,91,73.39%,1,0.81%,1
329,5178.0,128,45,35.16%,43,33.59%,48,37.50%,3,2.34%,2
330,1623.0,35,18,51.43%,18,51.43%,21,60.00%,3,8.57%,0
331,1627.0,98,77,78.57%,77,78.57%,78,79.59%,1,1.02%,0
333,7567.0,22,5,22.73%,5,22.73%,6,27.27%,1,4.55%,0
334,8224.0,145,58,40.00%,54,37.24%,74,51.03%,16,11.03%,4
336,1632.0,66,37,56.06%,33,50.00%,38,57.58%,1,1.52%,4
337,1654.0,200,118,59.00%,110,55.00%,119,59.50%,1,0.50%,8
339,1629.0,98,64,65.31%,58,59.18%,65,66.33%,1,1.02%,6
340,6136.0,101,66,65.35%,64,63.37%,69,68.32%,3,2.97%,2
341,6942.0,84,47,55.95%,46,54.76%,47,55.95%,0,0.00%,1
343,1677.0,169,93,55.03%,88,52.07%,96,56.80%,3,1.78%,5
345,1682.0,88,72,81.82%,72,81.82%,72,81.82%,0,0.00%,0
346,1694.0,334,241,72.16%,239,71.56%,242,72.46%,1,0.30%,2
348,1701.0,620,503,81.13%,500,80.65%,508,81.94%,5,0.81%,3
350,1707.0,180,135,75.00%,133,73.89%,135,75.00%,0,0.00%,2
352,5098.0,266,224,84.21%,212,79.70%,224,84.21%,0,0.00%,12
354,5221.0,229,143,62.45%,138,60.26%,144,62.88%,1,0.44%,5
355,6328.0,154,115,74.68%,112,72.73%,117,75.97%,2,1.30%,3
356,7774.0,768,311,40.49%,311,40.49%,419,54.56%,108,14.06%,0
357,1745.0,374,297,79.41%,294,78.61%,301,80.48%,4,1.07%,3
358,1746.0,294,199,67.69%,196,66.67%,203,69.05%,4,1.36%,3
360,5278.0,218,88,40.37%,76,34.86%,96,44.04%,8,3.67%,12
361,4801.0,280,235,83.93%,233,83.21%,237,84.64%,2,0.71%,2
363,6330.0,72,49,68.06%,49,68.06%,49,68.06%,0,0.00%,0
364,6333.0,188,78,41.49%,71,37.77%,78,41.49%,0,0.00%,7
365,7902.0,81,75,92.59%,75,92.59%,78,96.30%,3,3.70%,0
367,1776.0,283,219,77.39%,213,75.27%,219,77.39%,0,0.00%,6
368,7844.0,4,0,0.00%,0,0.00%,0,0.00%,0,0.00%,0
370,1790.0,133,100,75.19%,93,69.92%,102,76.69%,2,1.50%,7
372,1794.0,65,46,70.77%,42,64.62%,47,72.31%,1,1.54%,4
373,8278.0,42,31,73.81%,29,69.05%,33,78.57%,2,4.76%,2
374,1801.0,64,40,62.50%,40,62.50%,42,65.63%,2,3.13%,0
376,1806.0,202,174,86.14%,171,84.65%,175,86.63%,1,0.50%,3
378,6340.0,77,51,66.23%,50,64.94%,51,66.23%,0,0.00%,1
380,6492.0,106,66,62.26%,65,61.32%,66,62.26%,0,0.00%,1
381,8303.0,98,74,75.51%,66,67.35%,76,77.55%,2,2.04%,8
382,1849.0,222,167,75.23%,164,73.87%,180,81.08%,13,5.86%,3
384,0.0,1,0,0.00%,0,0.00%,0,0.00%,0,0.00%,0
385,1869.0,351,328,93.45%,328,93.45%,330,94.02%,2,0.57%,0
386,1879.0,427,391,91.57%,388,90.87%,392,91.80%,1,0.23%,3
388,1885.0,269,214,79.55%,211,78.44%,222,82.53%,8,2.97%,3
390,1902.0,285,244,85.61%,240,84.21%,250,87.72%,6,2.11%,4
392,1915.0,253,217,85.77%,215,84.98%,221,87.35%,4,1.58%,2
394,1921.0,273,260,95.24%,260,95.24%,260,95.24%,0,0.00%,0
396,1934.0,441,356,80.73%,349,79.14%,369,83.67%,13,2.95%,7
397,1942.0,333,309,92.79%,306,91.89%,320,96.10%,11,3.30%,3
399,6516.0,247,179,72.47%,178,72.06%,189,76.52%,10,4.05%,1
401,1950.0,285,263,92.28%,263,92.28%,266,93.33%,3,1.05%,0
403,1972.0,837,617,73.72%,599,71.57%,632,75.51%,15,1.79%,18
405,5287.0,293,263,89.76%,263,89.76%,264,90.10%,1,0.34%,0
406,8231.0,306,211,68.95%,192,62.75%,214,69.93%,3,0.98%,19
408,6218.0,41,24,58.54%,23,56.10%,25,60.98%,1,2.44%,1
409,1989.0,64,45,70.31%,45,70.31%,45,70.31%,0,0.00%,0
410,5169.0,137,86,62.77%,83,60.58%,93,67.88%,7,5.11%,3
412,7770.0,61,42,68.85%,26,42.62%,42,68.85%,0,0.00%,16
413,1998.0,173,81,46.82%,72,41.62%,92,53.18%,11,6.36%,9
414,2026.0,173,84,48.55%,84,48.55%,87,50.29%,3,1.73%,0
415,2027.0,138,79,57.25%,74,53.62%,79,57.25%,0,0.00%,5
416,7294.0,204,117,57.35%,101,49.51%,120,58.82%,3,1.47%,16
417,7515.0,179,178,99.44%,178,99.44%,178,99.44%,0,0.00%,0
419,6737.0,130,109,83.85%,109,83.85%,110,84.62%,1,0.77%,0
421,2037.0,140,83,59.29%,79,56.43%,90,64.29%,7,5.00%,4
423,2040.0,182,131,71.98%,125,68.68%,133,73.08%,2,1.10%,6
425,2043.0,135,80,59.26%,74,54.81%,82,60.74%,2,1.48%,6
427,7948.0,129,82,63.57%,82,63.57%,86,66.67%,4,3.10%,0
429,4817.0,85,55,64.71%,49,57.65%,57,67.06%,2,2.35%,6
430,8071.0,556,373,67.09%,369,66.37%,408,73.38%,35,6.29%,4
432,6145.0,116,76,65.52%,75,64.66%,79,68.10%,3,2.59%,1
434,6745.0,116,60,51.72%,46,39.66%,67,57.76%,7,6.03%,14
436,2075.0,65,0,0.00%,0,0.00%,0,0.00%,0,0.00%,0
437,6148.0,104,63,60.58%,59,56.73%,66,63.46%,3,2.88%,4
439,6001.0,265,153,57.74%,139,52.45%,167,63.02%,14,5.28%,14
440,4818.0,117,78,66.67%,68,58.12%,82,70.09%,4,3.42%,10
441,5228.0,200,128,64.00%,128,64.00%,143,71.50%,15,7.50%,0
443,2126.0,77,48,62.34%,48,62.34%,52,67.53%,4,5.19%,0
444,6600.0,264,202,76.52%,190,71.97%,216,81.82%,14,5.30%,12
446,6643.0,141,34,24.11%,34,24.11%,49,34.75%,15,10.64%,0
447,2184.0,178,112,62.92%,108,60.67%,116,65.17%,4,2.25%,4
449,6159.0,19,10,52.63%,9,47.37%,10,52.63%,0,0.00%,1
450,6161.0,32,26,81.25%,26,81.25%,26,81.25%,0,0.00%,0
451,2191.0,461,244,52.93%,237,51.41%,251,54.45%,7,1.52%,7
452,8244.0,107,57,53.27%,55,51.40%,58,54.21%,1,0.93%,2
454,2201.0,30,16,53.33%,14,46.67%,16,53.33%,0,0.00%,2
455,2206.0,211,155,73.46%,148,70.14%,158,74.88%,3,1.42%,7
456,6280.0,166,89,53.61%,89,53.61%,92,55.42%,3,1.81%,0
458,2243.0,280,180,64.29%,178,63.57%,190,67.86%,10,3.57%,2
459,6252.0,58,33,56.90%,30,51.72%,34,58.62%,1,1.72%,3
460,2246.0,27,16,59.26%,14,51.85%,16,59.26%,0,0.00%,2
461,2253.0,49,27,55.10%,27,55.10%,30,61.22%,3,6.12%,0
462,7112.0,62,42,67.74%,40,64.52%,42,67.74%,0,0.00%,2
463,5118.0,126,86,68.25%,72,57.14%,87,69.05%,1,0.79%,14
465,2280.0,59,34,57.63%,33,55.93%,36,61.02%,2,3.39%,1
466,2284.0,30,20,66.67%,20,66.67%,24,80.00%,4,13.33%,0
467,7136.0,60,23,38.33%,23,38.33%,23,38.33%,0,0.00%,0
468,2305.0,137,74,54.01%,70,51.09%,90,65.69%,16,11.68%,4
469,2308.0,58,25,43.10%,23,39.66%,27,46.55%,2,3.45%,2
470,7944.0,119,56,47.06%,49,41.18%,62,52.10%,6,5.04%,7
471,2313.0,85,43,50.59%,41,48.24%,46,54.12%,3,3.53%,2
472,7762.0,27,2,7.41%,2,7.41%,2,7.41%,0,0.00%,0
473,2353.0,51,38,74.51%,36,70.59%,45,88.24%,7,13.73%,2
474,4706.0,80,53,66.25%,47,58.75%,56,70.00%,3,3.75%,6
476,2331.0,72,47,65.28%,43,59.72%,48,66.67%,1,1.39%,4
477,2325.0,179,130,72.63%,128,71.51%,136,75.98%,6,3.35%,2
478,2339.0,108,58,53.70%,49,45.37%,63,58.33%,5,4.63%,9
480,2345.0,49,35,71.43%,34,69.39%,37,75.51%,2,4.08%,1
482,2350.0,64,42,65.63%,38,59.38%,44,68.75%,2,3.13%,4
483,2358.0,71,50,70.42%,48,67.61%,52,73.24%,2,2.82%,2
485,2362.0,60,29,48.33%,28,46.67%,32,53.33%,3,5.00%,1
486,6162.0,122,58,47.54%,57,46.72%,70,57.38%,12,9.84%,1
488,5180.0,85,22,25.88%,17,20.00%,28,32.94%,6,7.06%,5
489,6165.0,165,123,74.55%,107,64.85%,129,78.18%,6,3.64%,16
490,2394.0,81,31,38.27%,31,38.27%,44,54.32%,13,16.05%,0
491,6255.0,127,83,65.35%,75,59.06%,86,67.72%,3,2.36%,8
492,5091.0,253,231,91.30%,231,91.30%,235,92.89%,4,1.58%,0
493,2420.0,96,76,79.17%,72,75.00%,78,81.25%,2,2.08%,4
494,8312.0,115,100,86.96%,98,85.22%,100,86.96%,0,0.00%,2
495,6404.0,115,84,73.04%,84,73.04%,85,73.91%,1,0.87%,0
496,8304.0,105,76,72.38%,73,69.52%,76,72.38%,0,0.00%,3
497,2446.0,216,166,76.85%,158,73.15%,170,78.70%,4,1.85%,8
498,2449.0,59,45,76.27%,41,69.49%,45,76.27%,0,0.00%,4
500,2496.0,101,70,69.31%,70,69.31%,73,72.28%,3,2.97%,0
502,2489.0,189,129,68.25%,127,67.20%,133,70.37%,4,2.12%,2
503,6413.0,358,252,70.39%,252,70.39%,273,76.26%,21,5.87%,0
505,6775.0,182,156,85.71%,138,75.82%,158,86.81%,2,1.10%,18
506,6290.0,253,163,64.43%,159,62.85%,166,65.61%,3,1.19%,4
508,2515.0,64,30,46.88%,28,43.75%,30,46.88%,0,0.00%,2
510,2532.0,318,213,66.98%,195,61.32%,224,70.44%,11,3.46%,18
511,2539.0,190,124,65.26%,120,63.16%,132,69.47%,8,4.21%,4
513,2554.0,224,120,53.57%,116,51.79%,132,58.93%,12,5.36%,4
515,2562.0,276,204,73.91%,202,73.19%,210,76.09%,6,2.17%,2
517,6293.0,274,166,60.58%,149,54.38%,188,68.61%,22,8.03%,17
519,7538.0,25,23,92.00%,23,92.00%,23,92.00%,0,0.00%,0
520,2578.0,494,387,78.34%,382,77.33%,395,79.96%,8,1.62%,5
522,2607.0,244,182,74.59%,170,69.67%,189,77.46%,7,2.87%,12
523,2596.0,538,388,72.12%,374,69.52%,401,74.54%,13,2.42%,14
524,7922.0,131,60,45.80%,37,28.24%,67,51.15%,7,5.34%,23
526,2618.0,184,143,77.72%,129,70.11%,144,78.26%,1,0.54%,14
528,2623.0,388,326,84.02%,318,81.96%,334,86.08%,8,2.06%,8
530,2633.0,407,266,65.36%,246,60.44%,270,66.34%,4,0.98%,20
532,2649.0,138,70,50.72%,63,45.65%,73,52.90%,3,2.17%,7
534,2658.0,269,161,59.85%,149,55.39%,163,60.59%,2,0.74%,12
536,2663.0,371,280,75.47%,249,67.12%,280,75.47%,0,0.00%,31
537,2675.0,119,83,69.75%,72,60.50%,84,70.59%,1,0.84%,11
539,2680.0,100,84,84.00%,84,84.00%,84,84.00%,0,0.00%,0
541,4940.0,101,40,39.60%,37,36.63%,61,60.40%,21,20.79%,3
542,2686.0,121,101,83.47%,90,74.38%,101,83.47%,0,0.00%,11
544,2689.0,100,86,86.00%,81,81.00%,89,89.00%,3,3.00%,5
545,2704.0,153,102,66.67%,100,65.36%,108,70.59%,6,3.92%,2
547,2708.0,70,57,81.43%,56,80.00%,59,84.29%,2,2.86%,1
549,2712.0,51,37,72.55%,36,70.59%,39,76.47%,2,3.92%,1
550,2721.0,107,73,68.22%,73,68.22%,78,72.90%,5,4.67%,0
551,2725.0,120,83,69.17%,83,69.17%,89,74.17%,6,5.00%,0
553,4800.0,366,269,73.50%,256,69.95%,282,77.05%,13,3.55%,13
554,2740.0,149,97,65.10%,97,65.10%,107,71.81%,10,6.71%,0
556,5155.0,235,111,47.23%,102,43.40%,113,48.09%,2,0.85%,9
558,2760.0,151,95,62.91%,79,52.32%,99,65.56%,4,2.65%,16
559,2766.0,225,173,76.89%,173,76.89%,174,77.33%,1,0.44%,0
561,2794.0,482,304,63.07%,296,61.41%,314,65.15%,10,2.07%,8
562,2795.0,357,260,72.83%,254,71.15%,274,76.75%,14,3.92%,6
564,2798.0,108,84,77.78%,80,74.07%,85,78.70%,1,0.93%,4
566,2809.0,589,468,79.46%,459,77.93%,473,80.31%,5,0.85%,9
567,8210.0,24,10,41.67%,10,41.67%,10,41.67%,0,0.00%,0
568,7629.0,36,35,97.22%,35,97.22%,36,100.00%,1,2.78%,0
569,2818.0,117,84,71.79%,82,70.09%,85,72.65%,1,0.85%,2
571,2821.0,161,136,84.47%,134,83.23%,137,85.09%,1,0.62%,2
573,2829.0,755,630,83.44%,630,83.44%,633,83.84%,3,0.40%,0
575,2833.0,150,121,80.67%,121,80.67%,123,82.00%,2,1.33%,0
576,2839.0,235,159,67.66%,159,67.66%,161,68.51%,2,0.85%,0
578,2848.0,320,236,73.75%,231,72.19%,237,74.06%,1,0.31%,5
579,8125.0,51,50,98.04%,50,98.04%,51,100.00%,1,1.96%,0
580,2860.0,216,181,83.80%,180,83.33%,187,86.57%,6,2.78%,1
582,2869.0,198,174,87.88%,174,87.88%,175,88.38%,1,0.51%,0
583,5242.0,170,108,63.53%,107,62.94%,114,67.06%,6,3.53%,1
585,2891.0,135,101,74.81%,101,74.81%,101,74.81%,0,0.00%,0
587,7348.0,729,503,69.00%,496,68.04%,504,69.14%,1,0.14%,7
588,2924.0,152,122,80.26%,121,79.61%,125,82.24%,3,1.97%,1
590,2958.0,78,64,82.05%,64,82.05%,68,87.18%,4,5.13%,0
591,5058.0,249,207,83.13%,205,82.33%,213,85.54%,6,2.41%,2
592,5059.0,94,60,63.83%,58,61.70%,61,64.89%,1,1.06%,2
593,3007.0,213,1,0.47%,1,0.47%,1,0.47%,0,0.00%,0
594,3008.0,137,67,48.91%,66,48.18%,71,51.82%,4,2.92%,1
595,3009.0,130,95,73.08%,95,73.08%,100,76.92%,5,3.85%,0
597,6390.0,176,149,84.66%,149,84.66%,156,88.64%,7,3.98%,0
599,6391.0,321,238,74.14%,235,73.21%,248,77.26%,10,3.12%,3
601,6364.0,112,73,65.18%,73,65.18%,73,65.18%,0,0.00%,0
602,3034.0,187,111,59.36%,109,58.29%,119,63.64%,8,4.28%,2
604,4828.0,100,75,75.00%,73,73.00%,75,75.00%,0,0.00%,2
605,3040.0,56,44,78.57%,44,78.57%,44,78.57%,0,0.00%,0
607,3045.0,144,108,75.00%,106,73.61%,110,76.39%,2,1.39%,2
609,3048.0,72,43,59.72%,43,59.72%,43,59.72%,0,0.00%,0
610,3056.0,107,73,68.22%,73,68.22%,73,68.22%,0,0.00%,0
612,6368.0,293,163,55.63%,161,54.95%,163,55.63%,0,0.00%,2
614,4691.0,181,131,72.38%,126,69.61%,132,72.93%,1,0.55%,5
616,5245.0,92,52,56.52%,52,56.52%,53,57.61%,1,1.09%,0
617,3107.0,57,43,75.44%,32,56.14%,43,75.44%,0,0.00%,11
618,3111.0,71,36,50.70%,35,49.30%,39,54.93%,3,4.23%,1
619,3117.0,59,39,66.10%,38,64.41%,39,66.10%,0,0.00%,1
620,6122.0,42,19,45.24%,16,38.10%,21,50.00%,2,4.76%,3
621,5248.0,47,27,57.45%,26,55.32%,27,57.45%,0,0.00%,1
622,3137.0,134,80,59.70%,77,57.46%,89,66.42%,9,6.72%,3
623,7506.0,48,9,18.75%,2,4.17%,15,31.25%,6,12.50%,7
624,3145.0,141,104,73.76%,100,70.92%,109,77.30%,5,3.55%,4
625,6125.0,47,31,65.96%,26,55.32%,31,65.96%,0,0.00%,5
627,3150.0,169,140,82.84%,129,76.33%,140,82.84%,0,0.00%,11
628,6126.0,38,25,65.79%,20,52.63%,26,68.42%,1,2.63%,5
629,3155.0,83,44,53.01%,40,48.19%,54,65.06%,10,12.05%,4
630,3158.0,104,64,61.54%,62,59.62%,71,68.27%,7,6.73%,2
631,0.0,2,0,0.00%,0,0.00%,0,0.00%,0,0.00%,0
632,3165.0,79,50,63.29%,48,60.76%,52,65.82%,2,2.53%,2
634,8093.0,123,76,61.79%,71,57.72%,78,63.41%,2,1.63%,5
635,3124.0,108,82,75.93%,76,70.37%,85,78.70%,3,2.78%,6
636,6129.0,87,64,73.56%,56,64.37%,64,73.56%,0,0.00%,8
637,8187.0,373,185,49.60%,171,45.84%,206,55.23%,21,5.63%,14
638,7866.0,11,10,90.91%,10,90.91%,11,100.00%,1,9.09%,0
639,0.0,1,0,0.00%,0,0.00%,0,0.00%,0,0.00%,0
640,6935.0,331,259,78.25%,259,78.25%,263,79.46%,4,1.21%,0
641,7641.0,223,159,71.30%,159,71.30%,171,76.68%,12,5.38%,0
642,3210.0,488,393,80.53%,383,78.48%,399,81.76%,6,1.23%,10
643,3216.0,358,260,72.63%,260,72.63%,262,73.18%,2,0.56%,0
644,7738.0,430,278,64.65%,275,63.95%,293,68.14%,15,3.49%,3
646,3224.0,410,292,71.22%,290,70.73%,295,71.95%,3,0.73%,2
647,7687.0,227,133,58.59%,133,58.59%,146,64.32%,13,5.73%,0
648,3241.0,555,465,83.78%,465,83.78%,473,85.23%,8,1.44%,0
650,3260.0,342,306,89.47%,299,87.43%,311,90.94%,5,1.46%,7
652,3333.0,362,307,84.81%,305,84.25%,316,87.29%,9,2.49%,2
654,3272.0,394,352,89.34%,352,89.34%,357,90.61%,5,1.27%,0
656,8049.0,44,40,90.91%,39,88.64%,41,93.18%,1,2.27%,1
657,3295.0,300,273,91.00%,273,91.00%,284,94.67%,11,3.67%,0
658,3296.0,277,264,95.31%,263,94.95%,265,95.67%,1,0.36%,1
660,4960.0,175,161,92.00%,160,91.43%,161,92.00%,0,0.00%,1
661,3305.0,418,355,84.93%,354,84.69%,355,84.93%,0,0.00%,1
662,4958.0,58,24,41.38%,23,39.66%,24,41.38%,0,0.00%,1
663,6729.0,319,266,83.39%,253,79.31%,266,83.39%,0,0.00%,13
664,6998.0,46,26,56.52%,24,52.17%,26,56.52%,0,0.00%,2
666,5345.0,975,849,87.08%,844,86.56%,858,88.00%,9,0.92%,5
668,3328.0,465,408,87.74%,408,87.74%,413,88.82%,5,1.08%,0
670,3338.0,213,161,75.59%,154,72.30%,162,76.06%,1,0.47%,7
672,0.0,2,0,0.00%,0,0.00%,0,0.00%,0,0.00%,0
673,3348.0,146,93,63.70%,85,58.22%,98,67.12%,5,3.42%,8
675,3354.0,507,421,83.04%,416,82.05%,422,83.23%,1,0.20%,5
677,3376.0,164,145,88.41%,145,88.41%,148,90.24%,3,1.83%,0
678,3367.0,582,520,89.35%,519,89.18%,524,90.03%,4,0.69%,1
680,5078.0,336,320,95.24%,319,94.94%,320,95.24%,0,0.00%,1
682,3395.0,256,234,91.41%,228,89.06%,234,91.41%,0,0.00%,6
684,3401.0,207,169,81.64%,169,81.64%,173,83.57%,4,1.93%,0
686,5081.0,203,137,67.49%,133,65.52%,138,67.98%,1,0.49%,4
688,3247.0,344,325,94.48%,324,94.19%,330,95.93%,5,1.45%,1
690,3425.0,160,123,76.88%,123,76.88%,127,79.38%,4,2.50%,0
691,7681.0,39,34,87.18%,34,87.18%,34,87.18%,0,0.00%,0
692,0.0,2,1,50.00%,1,50.00%,1,50.00%,0,0.00%,0
693,3434.0,234,175,74.79%,175,74.79%,175,74.79%,0,0.00%,0
694,3465.0,553,440,79.57%,435,78.66%,449,81.19%,9,1.63%,5
695,4957.0,394,329,83.50%,328,83.25%,331,84.01%,2,0.51%,1
697,7634.0,105,92,87.62%,92,87.62%,95,90.48%,3,2.86%,0
698,3482.0,93,2,2.15%,2,2.15%,2,2.15%,0,0.00%,0
699,3495.0,372,331,88.98%,330,88.71%,334,89.78%,3,0.81%,1
700,3505.0,377,285,75.60%,279,74.01%,290,76.92%,5,1.33%,6
701,6439.0,152,117,76.97%,113,74.34%,120,78.95%,3,1.97%,4
702,5352.0,174,149,85.63%,148,85.06%,150,86.21%,1,0.57%,1
704,3522.0,160,134,83.75%,129,80.63%,137,85.63%,3,1.88%,5
706,3532.0,83,47,56.63%,47,56.63%,51,61.45%,4,4.82%,0
707,3541.0,140,60,42.86%,55,39.29%,60,42.86%,0,0.00%,5
708,6936.0,91,55,60.44%,54,59.34%,56,61.54%,1,1.10%,1
710,7893.0,144,103,71.53%,99,68.75%,103,71.53%,0,0.00%,4
712,3569.0,187,113,60.43%,107,57.22%,113,60.43%,0,0.00%,6
713,5103.0,117,75,64.10%,68,58.12%,75,64.10%,0,0.00%,7
714,6341.0,47,25,53.19%,25,53.19%,25,53.19%,0,0.00%,0
715,7930.0,73,54,73.97%,51,69.86%,58,79.45%,4,5.48%,3
716,3589.0,102,53,51.96%,52,50.98%,53,51.96%,0,0.00%,1
717,3596.0,166,92,55.42%,92,55.42%,94,56.63%,2,1.20%,0
719,8083.0,36,32,88.89%,32,88.89%,35,97.22%,3,8.33%,0
720,7678.0,68,65,95.59%,65,95.59%,67,98.53%,2,2.94%,0
721,7737.0,144,112,77.78%,111,77.08%,122,84.72%,10,6.94%,1
722,7776.0,68,61,89.71%,61,89.71%,61,89.71%,0,0.00%,0
723,7777.0,63,51,80.95%,46,73.02%,52,82.54%,1,1.59%,5
724,7829.0,99,88,88.89%,83,83.84%,88,88.89%,0,0.00%,5
725,7909.0,85,77,90.59%,77,90.59%,81,95.29%,4,4.71%,0
726,7910.0,83,73,87.95%,73,87.95%,73,87.95%,0,0.00%,0
727,8216.0,10,4,40.00%,4,40.00%,9,90.00%,5,50.00%,0
728,7510.0,121,83,68.60%,83,68.60%,87,71.90%,4,3.31%,0
729,7513.0,141,47,33.33%,47,33.33%,66,46.81%,19,13.48%,0
730,7540.0,144,108,75.00%,106,73.61%,108,75.00%,0,0.00%,2
731,7542.0,131,0,0.00%,0,0.00%,0,0.00%,0,0.00%,0
732,7546.0,56,52,92.86%,52,92.86%,53,94.64%,1,1.79%,0
733,7574.0,112,101,90.18%,100,89.29%,103,91.96%,2,1.79%,1
734,7578.0,141,120,85.11%,117,82.98%,120,85.11%,0,0.00%,3
735,7582.0,85,82,96.47%,82,96.47%,85,100.00%,3,3.53%,0
736,7586.0,81,77,95.06%,77,95.06%,78,96.30%,1,1.23%,0
737,7587.0,117,89,76.07%,88,75.21%,94,80.34%,5,4.27%,1
738,7649.0,96,88,91.67%,84,87.50%,89,92.71%,1,1.04%,4
739,7665.0,175,131,74.86%,116,66.29%,133,76.00%,2,1.14%,15
740,7666.0,257,231,89.88%,231,89.88%,237,92.22%,6,2.33%,0
741,8205.0,349,215,61.60%,214,61.32%,257,73.64%,42,12.03%,1
742,7671.0,162,162,100.00%,162,100.00%,162,100.00%,0,0.00%,0
743,7672.0,121,77,63.64%,77,63.64%,87,71.90%,10,8.26%,0
744,8207.0,227,150,66.08%,149,65.64%,155,68.28%,5,2.20%,1
745,8217.0,28,0,0.00%,0,0.00%,0,0.00%,0,0.00%,0
746,3728.0,17,0,0.00%,0,0.00%,0,0.00%,0,0.00%,0
747,3808.0,99,94,94.95%,94,94.95%,94,94.95%,0,0.00%,0
748,3816.0,221,65,29.41%,65,29.41%,66,29.86%,1,0.45%,0
749,3818.0,134,61,45.52%,60,44.78%,61,45.52%,0,0.00%,1
750,3841.0,117,0,0.00%,0,0.00%,0,0.00%,0,0.00%,0
751,3842.0,140,39,27.86%,39,27.86%,42,30.00%,3,2.14%,0
752,3843.0,194,165,85.05%,165,85.05%,165,85.05%,0,0.00%,0
753,3844.0,132,88,66.67%,87,65.91%,88,66.67%,0,0.00%,1
754,3845.0,311,105,33.76%,105,33.76%,107,34.41%,2,0.64%,0
755,3847.0,187,104,55.61%,104,55.61%,108,57.75%,4,2.14%,0
756,3848.0,505,452,89.50%,452,89.50%,453,89.70%,1,0.20%,0
757,3849.0,194,16,8.25%,16,8.25%,16,8.25%,0,0.00%,0
758,3850.0,239,5,2.09%,5,2.09%,5,2.09%,0,0.00%,0
759,3851.0,215,1,0.47%,1,0.47%,1,0.47%,0,0.00%,0
760,3855.0,552,424,76.81%,422,76.45%,426,77.17%,2,0.36%,2
761,3857.0,162,64,39.51%,64,39.51%,64,39.51%,0,0.00%,0
762,3859.0,231,75,32.47%,75,32.47%,77,33.33%,2,0.87%,0
763,3860.0,117,0,0.00%,0,0.00%,0,0.00%,0,0.00%,0
764,3861.0,95,62,65.26%,61,64.21%,62,65.26%,0,0.00%,1
765,6527.0,370,199,53.78%,199,53.78%,202,54.59%,3,0.81%,0
766,6548.0,72,69,95.83%,68,94.44%,71,98.61%,2,2.78%,1
767,6675.0,223,73,32.74%,73,32.74%,75,33.63%,2,0.90%,0
768,6822.0,157,113,71.97%,113,71.97%,114,72.61%,1,0.64%,0
769,6996.0,165,117,70.91%,117,70.91%,117,70.91%,0,0.00%,0
770,7023.0,171,144,84.21%,144,84.21%,145,84.80%,1,0.58%,0
771,7070.0,132,91,68.94%,91,68.94%,92,69.70%,1,0.76%,0
772,7072.0,157,115,73.25%,115,73.25%,118,75.16%,3,1.91%,0
773,7245.0,86,27,31.40%,27,31.40%,27,31.40%,0,0.00%,0
774,7255.0,52,33,63.46%,33,63.46%,33,63.46%,0,0.00%,0
775,7664.0,61,47,77.05%,47,77.05%,47,77.05%,0,0.00%,0
776,7780.0,66,53,80.30%,53,80.30%,53,80.30%,0,0.00%,0
777,7782.0,106,100,94.34%,100,94.34%,100,94.34%,0,0.00%,0
778,7808.0,87,69,79.31%,69,79.31%,70,80.46%,1,1.15%,0
779,7811.0,86,57,66.28%,56,65.12%,57,66.28%,0,0.00%,1
780,7813.0,104,23,22.12%,23,22.12%,23,22.12%,0,0.00%,0
781,7815.0,61,43,70.49%,42,68.85%,43,70.49%,0,0.00%,1
782,7850.0,58,33,56.90%,33,56.90%,34,58.62%,1,1.72%,0
783,7851.0,66,10,15.15%,10,15.15%,11,16.67%,1,1.52%,0
784,7852.0,84,49,58.33%,48,57.14%,52,61.90%,3,3.57%,1
785,7855.0,67,0,0.00%,0,0.00%,0,0.00%,0,0.00%,0
786,7903.0,140,97,69.29%,96,68.57%,98,70.00%,1,0.71%,1
787,7904.0,192,161,83.85%,160,83.33%,163,84.90%,2,1.04%,1
788,7905.0,83,81,97.59%,81,97.59%,82,98.80%,1,1.20%,0
789,7906.0,122,110,90.16%,110,90.16%,110,90.16%,0,0.00%,0
790,8039.0,123,97,78.86%,97,78.86%,98,79.67%,1,0.81%,0
791,8143.0,59,13,22.03%,13,22.03%,13,22.03%,0,0.00%,0
792,8293.0,54,22,40.74%,22,40.74%,22,40.74%,0,0.00%,0
793,8298.0,16,4,25.00%,4,25.00%,4,25.00%,0,0.00%,0
795,8195.0,151,123,81.46%,120,79.47%,126,83.44%,3,1.99%,3
796,7961.0,97,79,81.44%,78,80.41%,82,84.54%,3,3.09%,1
797,8122.0,8,4,50.00%,4,50.00%,4,50.00%,0,0.00%,0
798,7983.0,44,41,93.18%,41,93.18%,41,93.18%,0,0.00%,0
799,8127.0,47,46,97.87%,46,97.87%,46,97.87%,0,0.00%,0
800,8148.0,23,1,4.35%,1,4.35%,1,4.35%,0,0.00%,0
801,7981.0,99,88,88.89%,87,87.88%,92,92.93%,4,4.04%,1
802,8126.0,77,51,66.23%,51,66.23%,57,74.03%,6,7.79%,0
803,4310.0,282,169,59.93%,166,58.87%,176,62.41%,7,2.48%,3
804,5261.0,396,318,80.30%,313,79.04%,338,85.35%,20,5.05%,5
805,6222.0,18,7,38.89%,7,38.89%,9,50.00%,2,11.11%,0
806,3869.0,47,25,53.19%,25,53.19%,26,55.32%,1,2.13%,0
807,6223.0,14,9,64.29%,9,64.29%,9,64.29%,0,0.00%,0
808,3875.0,40,19,47.50%,19,47.50%,21,52.50%,2,5.00%,0
809,3877.0,35,18,51.43%,18,51.43%,21,60.00%,3,8.57%,0
810,3891.0,188,142,75.53%,127,67.55%,147,78.19%,5,2.66%,15
812,0.0,2,0,0.00%,0,0.00%,0,0.00%,0,0.00%,0
813,7012.0,85,59,69.41%,56,65.88%,59,69.41%,0,0.00%,3
814,0.0,2,0,0.00%,0,0.00%,0,0.00%,0,0.00%,0
815,6583.0,93,63,67.74%,53,56.99%,65,69.89%,2,2.15%,10
816,8161.0,8,3,37.50%,3,37.50%,3,37.50%,0,0.00%,0
817,3883.0,128,100,78.13%,100,78.13%,105,82.03%,5,3.91%,0
818,3910.0,111,64,57.66%,56,50.45%,69,62.16%,5,4.50%,8
819,3924.0,240,162,67.50%,144,60.00%,164,68.33%,2,0.83%,18
822,3940.0,66,42,63.64%,42,63.64%,44,66.67%,2,3.03%,0
824,5264.0,101,72,71.29%,71,70.30%,77,76.24%,5,4.95%,1
825,5070.0,143,127,88.81%,123,86.01%,128,89.51%,1,0.70%,4
826,3957.0,58,39,67.24%,34,58.62%,43,74.14%,4,6.90%,5
827,3914.0,68,45,66.18%,42,61.76%,47,69.12%,2,2.94%,3
828,3962.0,131,75,57.25%,74,56.49%,75,57.25%,0,0.00%,1
830,3969.0,201,121,60.20%,118,58.71%,123,61.19%,2,1.00%,3
831,6207.0,69,44,63.77%,42,60.87%,47,68.12%,3,4.35%,2
833,3978.0,77,57,74.03%,56,72.73%,63,81.82%,6,7.79%,1
834,3994.0,52,26,50.00%,25,48.08%,26,50.00%,0,0.00%,1
835,3988.0,81,49,60.49%,38,46.91%,49,60.49%,0,0.00%,11
836,6210.0,50,25,50.00%,23,46.00%,25,50.00%,0,0.00%,2
837,4002.0,31,19,61.29%,19,61.29%,21,67.74%,2,6.45%,0
838,4006.0,39,23,58.97%,22,56.41%,26,66.67%,3,7.69%,1
839,6800.0,29,12,41.38%,12,41.38%,12,41.38%,0,0.00%,0
840,8274.0,166,102,61.45%,97,58.43%,108,65.06%,6,3.61%,5
842,6216.0,25,12,48.00%,11,44.00%,14,56.00%,2,8.00%,1
844,4026.0,79,51,64.56%,51,64.56%,53,67.09%,2,2.53%,0
846,4030.0,44,28,63.64%,28,63.64%,30,68.18%,2,4.55%,0
847,4034.0,78,46,58.97%,46,58.97%,46,58.97%,0,0.00%,0
849,6418.0,80,43,53.75%,43,53.75%,43,53.75%,0,0.00%,0
850,6419.0,63,41,65.08%,36,57.14%,44,69.84%,3,4.76%,5
852,4044.0,116,80,68.97%,78,67.24%,80,68.97%,0,0.00%,2
853,4049.0,70,36,51.43%,36,51.43%,39,55.71%,3,4.29%,0
855,4054.0,54,38,70.37%,38,70.37%,39,72.22%,1,1.85%,0
857,4058.0,58,25,43.10%,25,43.10%,27,46.55%,2,3.45%,0
858,6373.0,78,47,60.26%,47,60.26%,48,61.54%,1,1.28%,0
859,4064.0,50,22,44.00%,22,44.00%,29,58.00%,7,14.00%,0
860,4068.0,81,42,51.85%,40,49.38%,43,53.09%,1,1.23%,2
861,4080.0,91,61,67.03%,57,62.64%,63,69.23%,2,2.20%,4
862,4085.0,143,123,86.01%,123,86.01%,123,86.01%,0,0.00%,0
864,4091.0,144,82,56.94%,82,56.94%,86,59.72%,4,2.78%,0
866,4098.0,90,55,61.11%,49,54.44%,55,61.11%,0,0.00%,6
867,4106.0,126,78,61.90%,68,53.97%,83,65.87%,5,3.97%,10
868,4931.0,147,73,49.66%,65,44.22%,80,54.42%,7,4.76%,8
870,1668.0,113,61,53.98%,55,48.67%,74,65.49%,13,11.50%,6
872,4126.0,67,42,62.69%,30,44.78%,43,64.18%,1,1.49%,12
873,7833.0,14,10,71.43%,10,71.43%,10,71.43%,0,0.00%,0
874,4135.0,65,44,67.69%,42,64.62%,49,75.38%,5,7.69%,2
875,4143.0,73,58,79.45%,49,67.12%,58,79.45%,0,0.00%,9
876,4146.0,43,23,53.49%,20,46.51%,23,53.49%,0,0.00%,3
877,4149.0,168,124,73.81%,119,70.83%,128,76.19%,4,2.38%,5
878,4165.0,38,15,39.47%,14,36.84%,24,63.16%,9,23.68%,1
880,4188.0,84,62,73.81%,49,58.33%,62,73.81%,0,0.00%,13
882,4181.0,101,61,60.40%,53,52.48%,62,61.39%,1,0.99%,8
883,0.0,1,0,0.00%,0,0.00%,0,0.00%,0,0.00%,0
884,4195.0,91,63,69.23%,60,65.93%,73,80.22%,10,10.99%,3
885,4203.0,74,50,67.57%,50,67.57%,57,77.03%,7,9.46%,0
887,0.0,3,0,0.00%,0,0.00%,0,0.00%,0,0.00%,0
888,4217.0,376,307,81.65%,275,73.14%,311,82.71%,4,1.06%,32
889,4715.0,98,71,72.45%,67,68.37%,73,74.49%,2,2.04%,4
890,4235.0,105,72,68.57%,65,61.90%,72,68.57%,0,0.00%,7
892,4242.0,84,55,65.48%,54,64.29%,56,66.67%,1,1.19%,1
893,4249.0,137,94,68.61%,94,68.61%,94,68.61%,0,0.00%,0
894,5083.0,350,331,94.57%,331,94.57%,334,95.43%,3,0.86%,0
896,7019.0,245,152,62.04%,141,57.55%,153,62.45%,1,0.41%,11
898,6012.0,225,151,67.11%,135,60.00%,155,68.89%,4,1.78%,16
900,4286.0,75,45,60.00%,38,50.67%,47,62.67%,2,2.67%,7
902,4295.0,212,140,66.04%,140,66.04%,148,69.81%,8,3.77%,0
904,6704.0,174,118,67.82%,116,66.67%,122,70.11%,4,2.30%,2
906,4930.0,210,163,77.62%,153,72.86%,167,79.52%,4,1.90%,10
907,4340.0,125,103,82.40%,99,79.20%,104,83.20%,1,0.80%,4
908,4352.0,166,123,74.10%,118,71.08%,124,74.70%,1,0.60%,5
910,4360.0,302,255,84.44%,254,84.11%,256,84.77%,1,0.33%,1
912,7550.0,39,18,46.15%,17,43.59%,23,58.97%,5,12.82%,1
913,4845.0,307,253,82.41%,248,80.78%,256,83.39%,3,0.98%,5
915,4373.0,206,175,84.95%,168,81.55%,175,84.95%,0,0.00%,7
917,4404.0,450,357,79.33%,349,77.56%,372,82.67%,15,3.33%,8
919,4412.0,55,44,80.00%,39,70.91%,45,81.82%,1,1.82%,5
921,4431.0,262,207,79.01%,168,64.12%,210,80.15%,3,1.15%,39
923,4442.0,123,97,78.86%,92,74.80%,101,82.11%,4,3.25%,5
925,6181.0,62,29,46.77%,29,46.77%,29,46.77%,0,0.00%,0
926,0.0,1,0,0.00%,0,0.00%,0,0.00%,0,0.00%,0
927,4458.0,148,124,83.78%,114,77.03%,126,85.14%,2,1.35%,10
929,8323.0,120,101,84.17%,93,77.50%,103,85.83%,2,1.67%,8
931,0.0,1,1,100.00%,1,100.00%,1,100.00%,0,0.00%,0
932,4717.0,371,270,72.78%,269,72.51%,280,75.47%,10,2.70%,1
934,6648.0,342,299,87.43%,294,85.96%,306,89.47%,7,2.05%,5
936,6191.0,154,107,69.48%,107,69.48%,116,75.32%,9,5.84%,0
937,4735.0,161,125,77.64%,113,70.19%,125,77.64%,0,0.00%,12
939,5271.0,183,108,59.02%,104,56.83%,111,60.66%,3,1.64%,4
940,4528.0,87,67,77.01%,67,77.01%,67,77.01%,0,0.00%,0
941,4545.0,404,298,73.76%,289,71.53%,308,76.24%,10,2.48%,9
943,4553.0,413,333,80.63%,322,77.97%,349,84.50%,16,3.87%,11
945,4558.0,214,131,61.21%,124,57.94%,135,63.08%,4,1.87%,7
947,4564.0,176,109,61.93%,94,53.41%,118,67.05%,9,5.11%,15
949,4571.0,93,46,49.46%,38,40.86%,49,52.69%,3,3.23%,8
951,7624.0,34,0,0.00%,0,0.00%,0,0.00%,0,0.00%,0
952,4577.0,223,143,64.13%,132,59.19%,152,68.16%,9,4.04%,11
954,4598.0,345,226,65.51%,211,61.16%,240,69.57%,14,4.06%,15
956,4602.0,182,130,71.43%,123,67.58%,133,73.08%,3,1.65%,7
958,4608.0,301,215,71.43%,200,66.45%,227,75.42%,12,3.99%,15
960,4614.0,232,197,84.91%,185,79.74%,202,87.07%,5,2.16%,12
962,4623.0,264,173,65.53%,163,61.74%,179,67.80%,6,2.27%,10
964,6705.0,201,148,73.63%,141,70.15%,155,77.11%,7,3.48%,7
966,4647.0,190,136,71.58%,135,71.05%,136,71.58%,0,0.00%,1
968,5168.0,309,104,33.66%,97,31.39%,111,35.92%,7,2.27%,7
969,4658.0,212,174,82.08%,174,82.08%,175,82.55%,1,0.47%,0
971,1732.0,297,228,76.77%,226,76.09%,228,76.77%,0,0.00%,2
972,4704.0,250,191,76.40%,184,73.60%,194,77.60%,3,1.20%,7
974,6345.0,201,133,66.17%,129,64.18%,135,67.16%,2,1.00%,4
976,8041.0,33,21,63.64%,21,63.64%,21,63.64%,0,0.00%,0
977,,"123,788","87,726",70.87%,"85,063",68.72%,"90,641",73.22%,"2,915",2.35%,"2,663"
978,,,,,,,,,,,
